portaveu	n	p O rr - t ax - B E1 uw
club	n	k l u1 p
cine	n	s i1 - n ax
fiscal	n	f i s - k a1 l
jugadors	n	Z u - G ax - D o1 s
pel·lícula	n	p ax - l i1 - k u - l ax
dilluns	n	d i - L u1 n s
candidat	n	k ax n - d i - D a1 t
jugador	n	Z u - G ax - D o1
los	n	l o1 s
dimarts	n	d i - m a1 rr s
euros	n	E1 uw - r u s
dimecres	n	d i - m e1 - k r ax s
futbol	n	f u b - b O1 l
firma	n	f i1 rr - m ax
assassinat	n	ax - s ax - s i - n a1 t
espectacle	n	ax s - p ax k - t a1 - k l ax
premi	n	p r E1 - m i
especialment	n	ax s - p ax - s i - a l - m e1 n
entrenador	n	ax n - t r ax - n ax - D o1
euro	n	E1 uw - r u
dòlars	n	d O1 - l ax rr s
actualment	n	ax k - t u - a l - m e1 n
escenari	n	ax - s ax - n a1 - r i
corresponsal	n	k u - rr ax s - p u n - s a1 l
vicepresident	n	b i - s ax - p r ax - z i - D e1 n
plantilla	n	p l ax n - t i1 - L ax
finalment	n	f i - n a l - m e1 n
regidor	n	rr ax - Z i - D o1
coalició	n	k u - ax - l i - s i - o1
juntament	n	Z u n - t ax - m e1 n
gol	n	g O1 l
film	n	f i1 l m
estrena	n	ax s - t r E1 - n ax
actriu	n	ax k - t r i1 uw
blaugrana	n	b l a uw - G r a1 - n ax
protesta	n	p r u - t e1 s - t ax
detingut	n	d ax - t i N - g u1 t
negociacions	n	n ax - G u - s i - ax - s i - o1 n s
rival	n	rr i - B a1 l
bilions	n	b i - l i - o1 n s
experts	n	ax k s - p E1 rr s
detinguts	n	d ax - t i N - g u1 t s
festival	n	f ax s - t i - B a1 l
las	n	l a1 s
terrorisme	n	t ax - rr u - r i1 z - m ax
gols	n	g O1 l s
precisament	n	p r ax - s i - z ax - m e1 n
finançament	n	f i - n ax n - s ax - m e1 n
atemptat	n	ax - t ax m - t a1 t
advocat	n	ax d - b u - k a1 t
policial	n	p O - l i - s i - a1 l
negociació	n	n ax - G u - s i - ax - s i - o1
clients	n	k l i - e1 n s
espectadors	n	ax s - p ax k - t ax - D o1 s
firmar	n	f i rr - m a1
entorn	n	ax n - t o1 rr n
borsa	n	b o1 rr - s ax
muntatge	n	m u n - t a1 d - Z ax
consistori	n	k u n - s i s - t O1 - r i
socis	n	s O1 - s i s
capdavant	n	k ax b - d ax - B a1 n
inflació	n	i m - f l ax - s i - o1
terroristes	n	t ax - rr u - r i1 s - t ax s
telèfon	n	t ax - l E1 - f u n
pensions	n	p ax n - s i - o1 n s
denúncia	n	d ax - n u1 n - s i - ax
comitè	n	k u - m i - t E1
refugiats	n	rr ax - f u - Z i - a1 t s
pista	n	p i1 s - t ax
pilota	n	p i - l O1 - t ax
agència	n	ax - Z E1 n - s i - ax
terrorista	n	t ax - rr u - r i1 s - t ax
entrega	n	ax n - t r e1 - G ax
pel·lícules	n	p ax - l i1 - k u - l ax s
candidatura	n	k ax n - d i - D ax - t u1 - r ax
ronda	n	rr o1 n - d ax
expresident	n	E k s - p r ax - z i - D e1 n
enrere	n	ax n - rr e1 - r ax
atemptats	n	ax - t ax m - t a1 t s
vacances	n	b ax - k a1 n - s ax s
delegat	n	d ax - l ax - G a1 t
rus	n	rr u1 s
bombers	n	b u m - b e1 s
entregar	n	ax n - t r ax - G a1
candidats	n	k ax n - d i - D a1 t s
empleats	n	ax m - p l e - a1 t s
torneig	n	t u rr - n E1 tS
hotel	n	u - t E1 l
sigut	n	s i - G u1 t
cimera	n	s i - m e1 - r ax
dimissió	n	d i - m i - s i - o1
premis	n	p r E1 - m i s
malament	n	m a - l ax - m e1 n
campió	n	k ax m - p i - o1
audiència	n	ax uw - D i - E1 n - s i - ax
consens	n	k u n - s E1 n s
totalment	n	t u - t a l - m e1 n
argentí	n	ax rr - Z ax n - t i1
negociar	n	n ax - G u - s i - a1
palestins	n	p ax - l ax s - t i1 n s
conveni	n	k u m - b E1 - n i
tropes	n	t r o1 - p ax s
plataforma	n	p l ax - t ax - f o1 rr - m ax
presumpte	n	p r ax - z u1 m - t ax
detenir	n	d ax - t ax - n i1
holandès	n	u - l ax n - d E1 s
incidents	n	i n - s i - D e1 n s
treva	n	t r e1 - B ax
assemblea	n	ax - s ax m - b l e1 - ax
domicili	n	d u - m i - s i1 - l i
advocats	n	ax d - b u - k a1 t s
detenció	n	d ax - t ax n - s i - o1
directament	n	d i - r E k - t ax - m e1 n
fiscalia	n	f i s - k ax - l i1 - ax
clubs	n	k l u1 p s
acusacions	n	ax - k u - z ax - s i - o1 n s
recinte	n	rr ax - s i1 n - t ax
metro	n	m E1 - t r u
davanter	n	d ax - B ax n - t e1
acusació	n	ax - k u - z ax - s i - o1
aniversari	n	ax - n i - B ax rr - s a1 - r i
legislatura	n	l ax - Z i z - l ax - t u1 - r ax
policials	n	p O - l i - s i - a1 l s
manifestants	n	m ax - n i - f ax s - t a1 n s
mandat	n	m ax n - d a1 t
firmes	n	f i1 rr - m ax s
respectivament	n	rr ax s - p ax k - t i - B ax - m e1 n
recentment	n	rr ax - s e m - m e1 n
pràcticament	n	p r a k - t i - k ax - m e1 n
crim	n	k r i1 m
quota	n	k w O1 - t ax
israelià	n	i z - rr ax - e - l i - a1
suspensió	n	s u s - p ax n - s i - o1
brasiler	n	b r ax - z i - l e1
firmat	n	f i rr - m a1 t
fiscals	n	f i s - k a1 l s
directius	n	d i - r ax k - t i1 uw s
corrupció	n	k u - rr u p - s i - o1
competició	n	k u m - p ax - t i - s i - o1
directiva	n	d i - r ax k - t i1 - B ax
arran	n	ax - rr a1 n
rock	n	rr O1 k
entrenament	n	ax n - t r ax - n ax - m e1 n
convocatòria	n	k u m - b u - k ax - t O1 - r i - ax
sol·licitar	n	s u - l i - s i - t a1
rècord	n	rr E1 - k u rr t
lamentar	n	l ax - m ax n - t a1
moció	n	m u - s i - o1
porter	n	p u rr - t e1
trimestre	n	t r i - m E1 s - t r ax
accionistes	n	ax k - s i - u - n i1 s - t ax s
conductor	n	k u n - d u k - t o1
atur	n	ax - t u1 rr
realment	n	rr e - a l - m e1 n
filial	n	f i - l i - a1 l
quilos	n	k i1 - l u s
túnel	n	t u1 - n ax l
escàndol	n	ax s - k a1 n - d u l
descans	n	d ax s - k a1 n s
penal	n	p ax - n a1 l
ministra	n	m i - n i1 s - t r ax
turistes	n	t u - r i1 s - t ax s
dictador	n	d i k - t ax - D o1
presidenta	n	p r ax - z i - D e1 n - t ax
vídeo	n	b i1 - D e - o
federal	n	f ax - D ax - r a1 l
visitants	n	b i - z i - t a1 n s
estrenar	n	ax s - t r ax - n a1
petroli	n	p ax - t r O1 - l i
jurat	n	Z u - r a1 t
regidors	n	rr ax - Z i - D o1 s
guió	n	g i - o1
permís	n	p ax rr - m i1 s
convocar	n	k u m - b u - k a1
patronal	n	p ax - t r u - n a1 l
pantalla	n	p ax n - t a1 - L ax
protestes	n	p r u - t e1 s - t ax s
descartar	n	d ax s - k ax rr - t a1
avinguda	n	ax - B i N - g u1 - D ax
palestí	n	p ax - l ax s - t i1
delegació	n	d ax - l ax - G ax - s i - o1
federació	n	f ax - D ax - r ax - s i - o1
renda	n	rr e1 n - d ax
ministeri	n	m i - n i s - t E1 - r i
probablement	n	p r u - B a b - b l ax - m e1 n
afició	n	ax - f i - s i - o1
publicitat	n	p u - B l i - s i - t a1 t
príncep	n	p r i1 n - s ax p
calendari	n	k ax - l ax n - d a1 - r i
comissari	n	k u - m i - s a1 - r i
serbis	n	s E1 r - B i s
cerimònia	n	s ax - r i - m O1 - n i - ax
retard	n	rr ax - t a1 rr t
irregularitats	n	i - rr ax - G u - l ax - r i - t a1 t s
conductors	n	k u n - d u k - t o1 s
comèdia	n	k u - m E1 - D i - ax
explosió	n	ax k s - p l u - z i - o1
inversors	n	i m - b ax rr - s o1 s
frau	n	f r a1 uw
presumptes	n	p r ax - z u1 m - t ax s
elèctrica	n	ax - l E1 k - t r i - k ax
directora	n	d i - r ax k - t o1 - r ax
digital	n	d i - Z i - t a1 l
aficionats	n	ax - f i - s i - u - n a1 t s
capità	n	k ax - p i - t a1
denúncies	n	d ax - n u1 n - s i - ax s
subvencions	n	s u b - b ax n - s i - o1 n s
cotització	n	k u - t i d - z ax - s i - o1
ofensiva	n	u - f ax n - s i1 - B ax
rodatge	n	rr u - D a1 d - Z ax
tecnologia	n	t ax g - n u - l u - Z i1 - ax
vigilància	n	b i - Z i - l a1 n - s i - ax
programació	n	p r u - G r ax - m ax - s i - o1
ingressar	n	i N - g r ax - s a1
bombardejos	n	b u m - b ax r - D E1 - Z u s
soci	n	s O1 - s i
disseny	n	d i - s E1 J
descomptat	n	d ax s - k u m - t a1 t
tragèdia	n	t r ax - Z E1 - D i - ax
militants	n	m i - l i - t a1 n s
suspendre	n	s u s - p E1 n - d r ax
autopista	n	ax uw - t u - p i1 s - t ax
censura	n	s ax n - s u1 - r ax
posteriorment	n	p u s - t ax - r i - o rr - m e1 n
inaugurar	n	i - n ax uw - G u - r a1
bar	n	b a1 rr
immediatament	n	i m - m ax - D i - a - t ax - m e1 n
gala	n	g a1 - l ax
iugoslau	n	y u - G u z - l a1 uw
rebaixa	n	rr ax - B a1 - S ax
magistrat	n	m ax - Z i s - t r a1 t
incident	n	i n - s i - D e1 n
descarta	n	d ax s - k a1 rr - t ax
arquitecte	n	ax rr - k i - t E1 k - t ax
disparar	n	d i s - p ax - r a1
postura	n	p u s - t u1 - r ax
votació	n	b u - t ax - s i - o1
emissió	n	ax - m i - s i - o1
tinent	n	t i - n e1 n
segrest	n	s ax - G r e1 s t
solucionar	n	s u - l u - s i - u - n a1
il·legal	n	i - l ax - G a1 l
oficialment	n	u - f i - s i - a l - m e1 n
russa	n	rr u1 - s ax
gerent	n	Z ax - r e1 n
enmig	n	ax m - m i1 tS
únicament	n	u - n i - k ax - m e1 n
urnes	n	u1 rr - n ax s
xilè	n	S i - l E1
participants	n	p ax rr - t i - s i - p a1 n s
guanyador	n	g w ax - J ax - D o1
trasllat	n	t r ax z - L a1 t
clarament	n	k l a - r ax - m e1 n
tecnologies	n	t ax g - n u - l u - Z i1 - ax s
analistes	n	ax - n ax - l i1 s - t ax s
infraestructures	n	i m - f r ax s - t r u k - t u1 - r ax s
israelians	n	i z - rr ax - e - l i - a1 n s
telecomunicacions	n	t E - l ax - k u - m u - n i - k ax - s i - o1 n s
telefonia	n	t ax - l ax - f u - n i1 - ax
restaurant	n	rr ax s - t ax uw - r a1 n
etarres	n	ax - t a1 - rr ax s
protagonitzar	n	p r u - t ax - G u - n i d - z a1
inauguració	n	i - n ax uw - G u - r ax - s i - o1
teatral	n	t e - ax - t r a1 l
xoc	n	S O1 k
virus	n	b i1 - r u s
completament	n	k u m - p l E - t ax - m e1 n
planeta	n	p l ax - n E1 - t ax
presideix	n	p r ax - z i - D E1 S
xou	n	S O1 uw
convivència	n	k u m - b i - B E1 n - s i - ax
càmeres	n	k a1 - m ax - r ax s
simplement	n	s i m - p l ax - m e1 n
comando	n	k u - m a1 n - d u
crims	n	k r i1 m s
expectatives	n	ax k s - p ax k - t ax - t i1 - B ax s
contundent	n	k u n - t u n - d e1 n
rivals	n	rr i - B a1 l s
marroquí	n	m ax - rr u - k i1
productor	n	p r u - D u k - t o1
fitxatge	n	f i t - S a1 d - Z ax
orquestra	n	u rr - k e1 s - t r ax
sida	n	s i1 - D ax
cineasta	n	s i - n e - a1 s - t ax
lo	n	l u
portuguès	n	p u rr - t u - G E1 s
extradició	n	ax k s - t r ax - D i - s i - o1
madrileny	n	m ax - D r i - l E1 J
investiga	n	i m - b ax s - t i1 - G ax
alarma	n	ax - l a1 rr - m ax
client	n	k l i - e1 n
protagonisme	n	p r u - t ax - G u - n i1 z - m ax
electrònic	n	ax - l ax k - t r O1 - n i k
vestidor	n	b ax s - t i - D o1
multinacional	n	m u l - t i - n ax - s i - u - n a1 l
realitzador	n	rr e - ax - l i d - z ax - D o1
invertir	n	i m - b ax rr - t i1
coordinador	n	k u - u r - D i - n ax - D o1
queixes	n	k e1 - S ax s
senador	n	s ax - n ax - D o1
pop	n	p o1 p
ordinador	n	u r - D i - n ax - D o1
golf	n	g O1 l f
inicialment	n	i - n i - s i - a l - m e1 n
multa	n	m u1 l - t ax
convocat	n	k u m - b u - k a1 t
russos	n	rr u1 - s u s
horari	n	u - r a1 - r i
empat	n	ax m - p a1 t
oci	n	O1 - s i
futbolista	n	f u b - b u - l i1 s - t ax
querella	n	k ax - r e1 - L ax
empresarial	n	ax m - p r ax - z ax - r i - a1 l
import	n	i m - p O1 rr t
belga	n	b E1 l - G ax
pistes	n	p i1 s - t ax s
cúpula	n	k u1 - p u - l ax
absolutament	n	ax p - s u - l u - t ax - m e1 n
persecució	n	p ax rr - s ax - k u - s i - o1
pactar	n	p ax k - t a1
sinistre	n	s i - n i1 s - t r ax
consorci	n	k u n - s O1 rr - s i
assassinats	n	ax - s ax - s i - n a1 t s
cadàver	n	k ax - D a1 - B ax rr
banqueta	n	b ax N - k E1 - t ax
segurament	n	s ax - G u - r ax - m e1 n
tele	n	t E1 - l ax
definitivament	n	d ax - f i - n i - t i - B ax - m e1 n
convidats	n	k u m - b i - D a1 t s
productors	n	p r u - D u k - t o1 s
rescat	n	rr ax s - k a1 t
semifinals	n	s E - m i - f i - n a1 l s
desfilada	n	d ax s - f i - l a1 - D ax
antiterrorista	n	a n - t i - t ax - rr u - r i1 s - t ax
espectador	n	ax s - p ax k - t ax - D o1
emergència	n	ax - m ax rr - Z E1 n - s i - ax
estalvi	n	ax s - t a1 l - B i
assistents	n	ax - s i s - t e1 n s
dòlar	n	d O1 - l ax rr
organitzadors	n	u r - G ax - n i d - z ax - D o1 s
instar	n	i n s - t a1
cru	n	k r u1
instal	n	i n s - t a1 l
tarifes	n	t ax - r i1 - f ax s
andalús	n	ax n - d ax - l u1 s
dansa	n	d a1 n - s ax
caos	n	k a1 - o s
luxe	n	l u1 k - s ax
urgència	n	u rr - Z E1 n - s i - ax
públicament	n	p u - B l i - k ax - m e1 n
regidora	n	rr ax - Z i - D o1 - r ax
jazz	n	Z a1 s
guerrilla	n	g ax - rr i1 - L ax
circuit	n	s i rr - k u1 j t
malestar	n	m ax - l ax s - t a1
perfectament	n	p ax rr - f e k - t ax - m e1 n
referèndum	n	rr ax - f ax - r E1 n - d u m
residus	n	rr ax - z i1 - D u s
etarra	n	ax - t a1 - rr ax
certamen	n	s ax rr - t a1 - m ax n
llicència	n	L i - s E1 n - s i - ax
autobusos	n	ax uw - t u - B u1 - z u s
cadàvers	n	k ax - D a1 - B ax rr s
il	n	i1 l
nomenament	n	n u - m ax - n ax - m e1 n
hotels	n	u - t E1 l s
llicències	n	L i - s E1 n - s i - ax s
esquí	n	ax s - k i1
comandant	n	k u - m ax n - d a1 n
vaques	n	b a1 - k ax s
alcaldia	n	ax l - k ax l - d i1 - ax
disputar	n	d i s - p u - t a1
debut	n	d ax - B u1 t
catedràtic	n	k ax - t ax - D r a1 - t i k
estrangeria	n	ax s - t r ax n - Z ax - r i1 - ax
comicis	n	k u - m i1 - s i s
protestar	n	p r u - t ax s - t a1
autobús	n	ax uw - t u - B u1 s
comunitari	n	k u - m u - n i - t a1 - r i
finançar	n	f i - n ax n - s a1
lideratge	n	l i - D ax - r a1 d - Z ax
comandament	n	k u - m ax n - d ax - m e1 n
cubà	n	k u - B a1
presumpta	n	p r ax - z u1 m - t ax
fallida	n	f ax - L i1 - D ax
espectacles	n	ax s - p ax k - t a1 - k l ax s
traspàs	n	t r ax s - p a1 s
gravar	n	g r ax - B a1
aparcament	n	ax - p ax rr - k ax - m e1 n
vianants	n	b i - ax - n a1 n s
intèrprets	n	i n - t E1 rr - p r ax t s
secretària	n	s ax - k r ax - t a1 - r i - ax
urbanització	n	u r - B ax - n i d - z ax - s i - o1
allau	n	ax - L a1 uw
sol·licitat	n	s u - l i - s i - t a1 t
gasolina	n	g ax - z u - l i1 - n ax
canceller	n	k ax n - s ax - L e1
escons	n	ax s - k o1 n s
contractar	n	k u n - t r ax k - t a1
fama	n	f a1 - m ax
directiu	n	d i - r ax k - t i1 uw
entrevistar	n	ax n - t r ax - B i s - t a1
veterà	n	b ax - t ax - r a1
apostar	n	ax - p u s - t a1
ciutadana	n	s i uw - t ax - D a1 - n ax
votants	n	b u - t a1 n s
lloguer	n	L u - G e1
là	n	l a1
subministrament	n	s u b - m i - n i s - t r ax - m e1 n
compareixença	n	k u m - p ax - r ax - S E1 n - s ax
expulsió	n	ax k s - p u l - s i - o1
magistrats	n	m ax - Z i s - t r a1 t s
ràpidament	n	rr a - p i - D ax - m e1 n
competir	n	k u m - p ax - t i1
marroquins	n	m ax - rr u - k i1 n s
sentenciar	n	s ax n - t ax n - s i - a1
casament	n	k ax - z ax - m e1 n
investigar	n	i m - b ax s - t i - G a1
mobilitzacions	n	m u - B i - l i d - z ax - s i - o1 n s
banca	n	b a1 N - k ax
bàsquet	n	b a1 s - k ax t
llançament	n	L ax n - s ax - m e1 n
avanç	n	ax - B a1 n s
principalment	n	p r i n - s i - p a l - m e1 n
delegats	n	d ax - l ax - G a1 t s
comerciants	n	k u - m ax rr - s i - a1 n s
ratificar	n	rr ax - t i - f i - k a1
contaminació	n	k u n - t ax - m i - n ax - s i - o1
comissaria	n	k u - m i - s ax - r i1 - ax
films	n	f i1 l m s
rebaixar	n	rr ax - B ax - S a1
càmera	n	k a1 - m ax - r ax
futbolistes	n	f u b - b u - l i1 s - t ax s
reportatge	n	rr ax - p u rr - t a1 d - Z ax
prioritat	n	p r i - u - r i - t a1 t
duel	n	d u - E1 l
governador	n	g u - B ax rr - n ax - D o1
con	n	k o1 n
assessor	n	ax - s ax - s o1
agències	n	ax - Z E1 n - s i - ax s
propietària	n	p r u - p i - ax - t a1 - r i - ax
facturació	n	f ax k - t u - r ax - s i - o1
unanimitat	n	u - n ax - n i - m i - t a1 t
productora	n	p r u - D u k - t o1 - r ax
liberalització	n	l i - B ax - r ax - l i d - z ax - s i - o1
ressaltar	n	rr ax - s ax l - t a1
madridista	n	m ax - D r i - D i1 s - t ax
autopistes	n	ax uw - t u - p i1 s - t ax s
comparèixer	n	k u m - p ax - r E1 - S ax
emissora	n	ax - m i - s o1 - r ax
editorial	n	ax - D i - t u - r i - a1 l
acomiadar	n	ax - k u - m i - ax - D a1
intèrpret	n	i n - t E1 rr - p r ax t
immoble	n	i m - m O1 b - b l ax
gallec	n	g ax - L E1 k
talibans	n	t ax - l i - B a1 n s
dimitir	n	d i - m i - t i1
argumentar	n	ax r - G u - m ax n - t a1
terror	n	t ax - rr o1 rr
terrible	n	t ax - rr i1 b - b l ax
centenari	n	s ax n - t ax - n a1 - r i
horaris	n	u - r a1 - r i s
ecologistes	n	ax - k u - l u - Z i1 s - t ax s
rumors	n	rr u - m o1 rr s
retallada	n	rr ax - t ax - L a1 - D ax
saló	n	s ax - l o1
guardó	n	g w ax r - D o1
carburants	n	k ax r - B u - r a1 n s
trama	n	t r a1 - m ax
enfront	n	ax m - f r o1 n
administrador	n	ax d - m i - n i s - t r ax - D o1
flamenc	n	f l ax - m E1 N
residents	n	rr ax - z i - D e1 n s
estrenarà	n	ax s - t r ax - n ax - r a1
presidencial	n	p r ax - z i - D ax n - s i - a1 l
ambaixador	n	ax m - b ax - S ax - D o1
queixa	n	k e1 - S ax
rehabilitació	n	rr e - ax - B i - l i - t ax - s i - o1
sèrbia	n	s E1 r - B i - ax
elèctriques	n	ax - l E1 k - t r i - k ax s
convidat	n	k u m - b i - D a1 t
eliminatòria	n	ax - l i - m i - n ax - t O1 - r i - ax
salarial	n	s ax - l ax - r i - a1 l
quotes	n	k w O1 - t ax s
lema	n	l e1 - m ax
suposadament	n	s u - p u - z a - D ax - m e1 n
igualment	n	i - G w a l - m e1 n
succés	n	s u k - s e1 s
fitxar	n	f i t - S a1
expert	n	ax k s - p E1 rr t
peatge	n	p e - a1 d - Z ax
personalment	n	p ax rr - s u - n a l - m e1 n
portaveus	n	p O rr - t ax - B E1 uw s
agrair	n	ax - G r ax - i1
tràmit	n	t r a1 - m i t
finalitzar	n	f i - n ax - l i d - z a1
elèctric	n	ax - l E1 k - t r i k
e	n	E1
solament	n	s O - l ax - m e1 n
pianista	n	p i - ax - n i1 s - t ax
detencions	n	d ax - t ax n - s i - o1 n s
ordinadors	n	u r - D i - n ax - D o1 s
demòcrates	n	d ax - m O1 - k r ax - t ax s
cartera	n	k ax rr - t e1 - r ax
fòrum	n	f O1 - r u m
exclusivament	n	ax k s - k l u - z i - B ax - m e1 n
gravació	n	g r ax - B ax - s i - o1
serbi	n	s E1 r - B i
inspecció	n	i n s - p ax k - s i - o1
borses	n	b o1 rr - s ax s
aproximadament	n	ax - p r u k - s i - m a - D ax - m e1 n
optimisme	n	u p - t i - m i1 z - m ax
mitjanit	n	m i d - Z ax - n i1 t
metropolitana	n	m ax - t r u - p u - l i - t a1 - n ax
governamental	n	g u - B ax rr - n ax - m ax n - t a1 l
replicar	n	rr ax - p l i - k a1
quadro	n	k w a1 - D r u
presidir	n	p r ax - z i - D i1
ingressat	n	i N - g r ax - s a1 t
ànim	n	a1 - n i m
àrbitre	n	a1 r - B i - t r ax
queixar	n	k ax - S a1
armada	n	ax rr - m a1 - D ax
tranquil·litat	n	t r ax N - k i - l i - t a1 t
debutar	n	d ax - B u - t a1
rector	n	rr ax k - t o1
factura	n	f ax k - t u1 - r ax
localitzar	n	l u - k ax - l i d - z a1
gasoil	n	g ax - z O1 j l
rebels	n	rr ax - B E1 l s
desastre	n	d ax - z a1 s - t r ax
derrotar	n	d ax - rr u - t a1
disputa	n	d i s - p u1 - t ax
integrants	n	i n - t ax - G r a1 n s
fuga	n	f u1 - G ax
agenda	n	ax - Z e1 n - d ax
cobertura	n	k u - B ax rr - t u1 - r ax
animar	n	ax - n i - m a1
desmentir	n	d ax z - m ax n - t i1
tràmits	n	t r a1 - m i t s
semestre	n	s ax - m E1 s - t r ax
presumptament	n	p r ax - z u m - t ax - m e1 n
rendibilitat	n	rr ax n - d i - B i - l i - t a1 t
alertar	n	ax - l ax rr - t a1
informatius	n	i m - f u rr - m ax - t i1 uw s
campionat	n	k ax m - p i - u - n a1 t
successor	n	s u k - s ax - s o1
promotors	n	p r u - m u - t o1 s
escenaris	n	ax - s ax - n a1 - r i s
desocupació	n	d ax - z u - k u - p ax - s i - o1
operadora	n	u - p ax - r ax - D o1 - r ax
seguiment	n	s ax - G i - m e1 n
princesa	n	p r i n - s E1 - z ax
guitarra	n	g i - t a1 - rr ax
diàriament	n	d i - a - r i - ax - m e1 n
avís	n	ax - B i1 s
magribins	n	m ax - G r i - B i1 n s
titulars	n	t i - t u - l a1 rr s
argentina	n	ax rr - Z ax n - t i1 - n ax
sumari	n	s u - m a1 - r i
possiblement	n	p u - s i b - b l ax - m e1 n
anotar	n	ax - n u - t a1
explosius	n	ax k s - p l u - z i1 uw s
entregat	n	ax n - t r ax - G a1 t
informàtica	n	i m - f u rr - m a1 - t i - k ax
religió	n	rr ax - l i - Z i - o1
informatiu	n	i m - f u rr - m ax - t i1 uw
políticament	n	p u - l i - t i - k ax - m e1 n
credibilitat	n	k r ax - D i - B i - l i - t a1 t
discoteca	n	d i s - k u - t E1 - k ax
holandesa	n	u - l ax n - d E1 - z ax
implantació	n	i m - p l ax n - t ax - s i - o1
seriosament	n	s ax - r i - o - z ax - m e1 n
samarreta	n	s ax - m ax - rr E1 - t ax
sèrbies	n	s E1 r - B i - ax s
convocada	n	k u m - b u - k a1 - D ax
seleccionador	n	s ax - l ax k - s i - u - n ax - D o1
salari	n	s ax - l a1 - r i
israeliana	n	i z - rr ax - e - l i - a1 - n ax
revés	n	rr ax - B e1 s
focus	n	f o1 - k u s
porteria	n	p u rr - t ax - r i1 - ax
fallar	n	f ax - L a1
prèviament	n	p r E - B i - ax - m e1 n
restaurants	n	rr ax s - t ax uw - r a1 n s
reivindicar	n	rr ax - i - B i n - d i - k a1
contactar	n	k u n - t ax k - t a1
electricitat	n	ax - l ax k - t r i - s i - t a1 t
dispositiu	n	d i s - p u - z i - t i1 uw
laboratori	n	l ax - B u - r ax - t O1 - r i
violació	n	b i - u - l ax - s i - o1
pensió	n	p ax n - s i - o1
cessió	n	s ax - s i - o1
sorteig	n	s u rr - t E1 tS
aspirants	n	ax s - p i - r a1 n s
medalla	n	m ax - D a1 - L ax
recaptació	n	rr ax - k ax p - t ax - s i - o1
beneficiar	n	b ax - n ax - f i - s i - a1
legislatives	n	l ax - Z i z - l ax - t i1 - B ax s
operadors	n	u - p ax - r ax - D o1 s
favorit	n	f ax - B u - r i1 t
suplents	n	s u - p l e1 n s
recalcar	n	rr ax - k ax l - k a1
processat	n	p r u - s ax - s a1 t
centrecampista	n	s e n - t r ax - k ax m - p i1 s - t ax
ciclista	n	s i - k l i1 s - t ax
empresarials	n	ax m - p r ax - z ax - r i - a1 l s
toros	n	t O1 - r u s
inseguretat	n	i n - s ax - G u - r ax - t a1 t
dictamen	n	d i k - t a1 - m ax n
criminal	n	k r i - m i - n a1 l
contràriament	n	k u n - t r a - r i - ax - m e1 n
optimista	n	u p - t i - m i1 s - t ax
emissions	n	ax - m i - s i - o1 n s
tenor	n	t ax - n o1 rr
albanesos	n	ax l - B ax - n E1 - z u s
exhibició	n	ax g - z i - B i - s i - o1
maniobra	n	m ax - n i - O1 - B r ax
molèsties	n	m u - l E1 s - t i - ax s
excusa	n	ax k s - k u1 - z ax
viuda	n	b i1 uw - D ax
verdadera	n	b ax r - D ax - D e1 - r ax
salaris	n	s ax - l a1 - r i s
venjança	n	b ax n - Z a1 n - s ax
majoritàriament	n	m ax - Z u - r i - t a - r i - ax - m e1 n
dissenyat	n	d i - s ax - J a1 t
discriminació	n	d i s - k r i - m i - n ax - s i - o1
assalt	n	ax - s a1 l
telèfons	n	t ax - l E1 - f u n s
diputada	n	d i - p u - t a1 - D ax
transparència	n	t r ax n s - p ax - r E1 n - s i - ax
calçada	n	k ax l - s a1 - D ax
assassinar	n	ax - s ax - s i - n a1
protagonitzada	n	p r u - t ax - G u - n i d - z a1 - D ax
consellera	n	k u n - s ax - L e1 - r ax
verdader	n	b ax r - D ax - D e1
indignació	n	i n - d i g - n ax - s i - o1
talent	n	t ax - l e1 n
agressor	n	ax - G r ax - s o1
fundador	n	f u n - d ax - D o1
assassí	n	ax - s ax - s i1
guerrillers	n	g ax - rr i - L e1 s
reformar	n	rr ax - f u rr - m a1
emissores	n	ax - m i - s o1 - r ax s
emoció	n	ax - m u - s i - o1
il·legals	n	i - l ax - G a1 l s
mundialització	n	m u n - d i - ax - l i d - z ax - s i - o1
audiovisual	n	ax uw - D i - u - B i - z u - a1 l
fax	n	f a1 k s
maltractaments	n	m a l - t r ax k - t ax - m e1 n s
habitualment	n	ax - B i - t u - a l - m e1 n
tarifa	n	t ax - r i1 - f ax
lamenta	n	l ax - m e1 n - t ax
ecologista	n	ax - k u - l u - Z i1 s - t ax
virtual	n	b i rr - t u - a1 l
demòcrata	n	d ax - m O1 - k r ax - t ax
recital	n	rr ax - s i - t a1 l
bars	n	b a1 rr s
planter	n	p l ax n - t e1
telefònic	n	t ax - l ax - f O1 - n i k
candidatures	n	k ax n - d i - D ax - t u1 - r ax s
subhasta	n	s u - B a1 s - t ax
presidencials	n	p r ax - z i - D ax n - s i - a1 l s
marcador	n	m ax rr - k ax - D o1
abstenció	n	ax p s - t ax n - s i - o1
urgències	n	u rr - Z E1 n - s i - ax s
guitarrista	n	g i - t ax - rr i1 s - t ax
ficció	n	f i k - s i - o1
alcaldessa	n	ax l - k ax l - d E1 - s ax
cantants	n	k ax n - t a1 n s
infraestructura	n	i m - f r ax s - t r u k - t u1 - r ax
pacificació	n	p ax - s i - f i - k ax - s i - o1
endarrerir	n	ax n - d ax - rr ax - r i1
permisos	n	p ax rr - m i1 - z u s
saldar	n	s ax l - d a1
felicitar	n	f ax - l i - s i - t a1
encarna	n	ax N - k a1 rr - n ax
bloqueig	n	b l u - k E1 tS
incertesa	n	i n - s ax rr - t E1 - z ax
lletrat	n	L ax - t r a1 t
disputarà	n	d i s - p u - t ax - r a1
privatització	n	p r i - B ax - t i d - z ax - s i - o1
empleat	n	ax m - p l e - a1 t
catàstrofe	n	k ax - t a1 s - t r u - f ax
electrònica	n	ax - l ax k - t r O1 - n i - k ax
combustible	n	k u m - b u s - t i1 b - b l ax
moto	n	m o1 - t u
exactament	n	ax g - z a k - t ax - m e1 n
companya	n	k u m - p a1 - J ax
retencions	n	rr ax - t ax n - s i - o1 n s
còpies	n	k O1 - p i - ax s
avaria	n	ax - B ax - r i1 - ax
intimitat	n	i n - t i - m i - t a1 t
accionista	n	ax k - s i - u - n i1 s - t ax
acostament	n	ax - k u s - t ax - m e1 n
peatges	n	p e - a1 d - Z ax s
convergent	n	k u m - b ax rr - Z e1 n
benestar	n	b e - n ax s - t a1
arrest	n	ax - rr e1 s t
austríac	n	ax uw s - t r i1 - ax k
imminent	n	i m - m i - n e1 n
vistiplau	n	b i s - t i - p l a1 uw
entrenaments	n	e n - t r ax - n ax - m e1 n s
bateria	n	b ax - t ax - r i1 - ax
bàsicament	n	b a - z i - k ax - m e1 n
ciutadania	n	s i uw - t ax - D ax - n i1 - ax
candidata	n	k ax n - d i - D a1 - t ax
artefacte	n	ax rr - t ax - f a1 k - t ax
defensor	n	d ax - f ax n - s o1
diligències	n	d i - l i - Z E1 n - s i - ax s
mobilització	n	m u - B i - l i d - z ax - s i - o1
legalitat	n	l ax - G ax - l i - t a1 t
sol·licitud	n	s u - l i - s i - t u1 t
sondeig	n	s u n - d E1 tS
esportistes	n	ax s - p u rr - t i1 s - t ax s
previsible	n	p r ax - B i - z i1 b - b l ax
penals	n	p ax - n a1 l s
comunitària	n	k u - m u - n i - t a1 - r i - ax
xinès	n	S i - n E1 s
subvenció	n	s u b - b ax n - s i - o1
pàrquing	n	p a1 rr - k i N
entrenar	n	ax n - t r ax - n a1
terminal	n	t ax rr - m i - n a1 l
carril	n	k ax - rr i1 l
sospitós	n	s u s - p i - t o1 s
soprano	n	s u - p r a1 - n u
armats	n	ax rr - m a1 t s
curiosament	n	k u - r i - o - z ax - m e1 n
eludir	n	ax - l u - D i1
extinció	n	ax k s - t i n - s i - o1
taxi	n	t a1 k - s i
transcurs	n	t r ax n s - k u1 rr s
protagonitzat	n	p r u - t ax - G u - n i d - z a1 t
accelerar	n	ax k - s ax - l ax - r a1
homicidi	n	u - m i - s i1 - D i
casc	n	k a1 s k
rebaixes	n	rr ax - B a1 - S ax s
sospitosos	n	s u s - p i - t o1 - z u s
exhibir	n	ax g - z i - B i1
gestiona	n	Z ax s - t i - o1 - n ax
plenament	n	p l E - n ax - m e1 n
sondejos	n	s u n - d E1 - Z u s
coronel	n	k u - r u - n E1 l
informàtic	n	i m - f u rr - m a1 - t i k
autocar	n	ax uw - t u - k a1 rr
autogovern	n	a uw - t u - G u - B E1 rr n
telefònica	n	t E - l ax - f O1 - n i - k ax
complicitat	n	k u m - p l i - s i - t a1 t
estalvis	n	ax s - t a1 l - B i s
arquitectes	n	ax rr - k i - t E1 k - t ax s
escalada	n	ax s - k ax - l a1 - D ax
advocar	n	ax d - b u - k a1
prestacions	n	p r ax s - t ax - s i - o1 n s
humanitària	n	u - m ax - n i - t a1 - r i - ax
fans	n	f a1 n s
convenis	n	k u m - b E1 - n i s
ironia	n	i - r u - n i1 - ax
diplomàtic	n	d i - p l u - m a1 - t i k
col	n	k O1 l
contenidors	n	k u n - t ax - n i - D o1 s
fabricants	n	f ax - B r i - k a1 n s
elogiar	n	ax - l u - Z i - a1
flota	n	f l O1 - t ax
destitució	n	d ax s - t i - t u - s i - o1
russes	n	rr u1 - s ax s
míssils	n	m i1 - s i l s
motos	n	m o1 - t u s
pressionar	n	p r ax - s i - u - n a1
veto	n	b E1 - t u
racisme	n	rr ax - s i1 z - m ax
olímpic	n	u - l i1 m - p i k
aplaudiments	n	ax - p l ax uw - D i - m e1 n s
enllaç	n	ax J - L a1 s
fitxatges	n	f i t - S a1 d - Z ax s
carnet	n	k ax rr - n E1 t
ajornar	n	ax - Z u rr - n a1
suggeriments	n	s u g - Z ax - r i - m e1 n s
militant	n	m i - l i - t a1 n
escriptora	n	ax s - k r i p - t o1 - r ax
clausura	n	k l ax uw - z u1 - r ax
liderat	n	l i - D ax - r a1 t
rescatar	n	rr ax s - k ax - t a1
regal	n	rr ax - G a1 l
baralla	n	b ax - r a1 - L ax
presidit	n	p r ax - z i - D i1 t
tennista	n	t ax n - n i1 s - t ax
popularitat	n	p u - p u - l ax - r i - t a1 t
multinacionals	n	m u l - t i - n ax - s i - u - n a1 l s
elit	n	ax - l i1 t
imputat	n	i m - p u - t a1 t
australià	n	ax uw s - t r ax - l i - a1
invertit	n	i m - b ax rr - t i1 t
gestionar	n	Z ax s - t i - u - n a1
conselleria	n	k u n - s ax - L ax - r i1 - ax
connectar	n	k u n - n ax k - t a1
comunitaris	n	k u - m u - n i - t a1 - r i s
favorits	n	f ax - B u - r i1 t s
polígon	n	p u - l i1 - G u n
al·legacions	n	ax - l ax - G ax - s i - o1 n s
jubilació	n	Z u - B i - l ax - s i - o1
elogis	n	ax - l O1 - Z i s
postal	n	p u s - t a1 l
estafa	n	ax s - t a1 - f ax
mexicà	n	m ax k - s i - k a1
toc	n	t O1 k
piscina	n	p i - s i1 - n ax
franquisme	n	f r ax N - k i1 z - m ax
dissenyar	n	d i - s ax - J a1
homòleg	n	u - m O1 - l ax k
meta	n	m E1 - t ax
nòvio	n	n O1 - B i - u
encàrrec	n	ax N - k a1 - rr ax k
governamentals	n	g u - B ax rr - n ax - m ax n - t a1 l s
segell	n	s ax - Z e1 L
helicòpter	n	ax - l i - k O1 p - t ax rr
protocol	n	p r u - t u - k O1 l
cardenal	n	k ax r - D ax - n a1 l
raonable	n	rr ax - u - n a1 b - b l ax
advertència	n	ax d - b ax rr - t E1 n - s i - ax
gespa	n	Z e1 s - p ax
semifinal	n	s E - m i - f i - n a1 l
comunitàries	n	k u - m u - n i - t a1 - r i - ax s
senadors	n	s ax - n ax - D o1 s
veredicte	n	b ax - r ax - D i1 k - t ax
pancartes	n	p ax N - k a1 rr - t ax s
discrepàncies	n	d i s - k r ax - p a1 n - s i - ax s
albanokosovars	n	ax l - B ax - n u - k u - z u - B a1 s
col·legues	n	k u - l E1 - G ax s
cinematogràfica	n	s i - n ax - m ax - t u - G r a1 - f i - k ax
vigília	n	b i - Z i1 - l i - ax
armat	n	ax rr - m a1 t
portuguesa	n	p u rr - t u - G E1 - z ax
caça	n	k a1 - s ax
suspès	n	s u s - p E1 s
ambició	n	ax m - b i - s i - o1
inspectors	n	i n s - p ax k - t o1 s
enquestats	n	ax N - k ax s - t a1 t s
tirs	n	t i1 rr s
pactat	n	p ax k - t a1 t
pavelló	n	p ax - B ax - L o1
multes	n	m u1 l - t ax s
titularitat	n	t i - t u - l ax - r i - t a1 t
devolució	n	d ax - B u - l u - s i - o1
xocar	n	S u - k a1
sonora	n	s u - n o1 - r ax
kosovars	n	k u - z u - B a1 s
madrilenya	n	m ax - D r i - l E1 - J ax
arquitectura	n	ax rr - k i - t ax k - t u1 - r ax
encapçala	n	ax N - k ax p - s a1 - l ax
ubicació	n	u - B i - k ax - s i - o1
endarreriments	n	ax n - d ax - rr ax - r i - m e1 n s
imputats	n	i m - p u - t a1 t s
caserna	n	k ax - z E1 rr - n ax
viabilitat	n	b i - ax - B i - l i - t a1 t
preparador	n	p r ax - p ax - r ax - D o1
cable	n	k a1 b - b l ax
titllar	n	t i L - L a1
cantautor	n	k ax n - t ax uw - t o1
jubilats	n	Z u - B i - l a1 t s
fitxa	n	f i1 t - S ax
presidida	n	p r ax - z i - D i1 - D ax
submarí	n	s u b - m ax - r i1
prevaricació	n	p r ax - B ax - r i - k ax - s i - o1
rematar	n	rr ax - m ax - t a1
insta	n	i1 n s - t ax
assassins	n	ax - s ax - s i1 n s
eco	n	E1 - k u
autovia	n	a uw - t u - B i1 - ax
preservar	n	p r ax - z ax r - B a1
autodeterminació	n	a uw - t u - D ax - t ax rr - m i - n ax - s i - o1
gir	n	Z i1 rr
captura	n	k ax p - t u1 - r ax
helicòpters	n	ax - l i - k O1 p - t ax rr s
amistós	n	ax - m i s - t o1 s
nadó	n	n ax - D o1
inspector	n	i n s - p ax k - t o1
immobiliària	n	i m - m u - B i - l i - a1 - r i - ax
apujar	n	ax - p u - Z a1
gravat	n	g r ax - B a1 t
deteriorament	n	d ax - t ax - r i - u - r ax - m e1 n
televisiva	n	t ax - l ax - B i - z i1 - B ax
lli	n	L i1
adjunt	n	ax d - Z u1 n
mensuals	n	m ax n - s u - a1 l s
substitut	n	s u p s - t i - t u1 t
conjuntament	n	k u n - Z u n - t ax - m e1 n
brasilera	n	b r ax - z i - l e1 - r ax
activistes	n	ax k - t i - B i1 s - t ax s
llargmetratge	n	L a rr g - m ax - t r a1 d - Z ax
tennis	n	t E1 n - n i s
competitivitat	n	k u m - p ax - t i - t i - B i - t a1 t
ciclistes	n	s i - k l i1 s - t ax s
veïnal	n	b ax - i - n a1 l
tàctica	n	t a1 k - t i - k ax
convocats	n	k u m - b u - k a1 t s
diplomàcia	n	d i - p l u - m a1 - s i - ax
lamentable	n	l ax - m ax n - t a1 b - b l ax
exclusió	n	ax k s - k l u - z i - o1
veterans	n	b ax - t ax - r a1 n s
farmacèutica	n	f ax rr - m ax - s E1 uw - t i - k ax
encapçalar	n	ax N - k ax p - s ax - l a1
ocupants	n	u - k u - p a1 n s
col·locació	n	k u - l u - k ax - s i - o1
bancari	n	b ax N - k a1 - r i
suec	n	s u - E1 k
escó	n	ax s - k o1
desarmament	n	d ax - z ax rr - m ax - m e1 n
enviament	n	ax m - b i - ax - m e1 n
estavellar	n	ax s - t ax - B ax - L a1
bloquejar	n	b l u - k ax - Z a1
innocència	n	i n - n u - s E1 n - s i - ax
duo	n	d u1 - o
monarca	n	m u - n a1 rr - k ax
abocador	n	ax - B u - k ax - D o1
rere	n	rr e1 - r ax
gestora	n	Z ax s - t o1 - r ax
prevenir	n	p r ax - B ax - n i1
acomiadament	n	ax - k u - m i - ax - D ax - m e1 n
recaptar	n	rr ax - k ax p - t a1
setmanari	n	s ax m - m ax - n a1 - r i
difícilment	n	d i - f i - s i l - m e1 n
suís	n	s u - i1 s
africans	n	ax - f r i - k a1 n s
concretament	n	k u N - k r e - t ax - m e1 n
contundència	n	k u n - t u n - d E1 n - s i - ax
destinació	n	d ax s - t i - n ax - s i - o1
triomfar	n	t r i - u m - f a1
fortalesa	n	f u rr - t ax - l E1 - z ax
tortures	n	t u rr - t u1 - r ax s
urbanística	n	u r - B ax - n i1 s - t i - k ax
rotatiu	n	rr u - t ax - t i1 uw
anteriorment	n	ax n - t ax - r i - o rr - m e1 n
addicional	n	ax d - d i - s i - u - n a1 l
immunitat	n	i m - m u - n i - t a1 t
reestructuració	n	rr e - ax s - t r u k - t u - r ax - s i - o1
promocionar	n	p r u - m u - s i - u - n a1
xilena	n	S i - l E1 - n ax
cessament	n	s ax - s ax - m e1 n
nazis	n	n a1 - z i s
vencedor	n	b ax n - s ax - D o1
puntualitzar	n	p u n - t u - ax - l i d - z a1
ratxa	n	rr a1 t - S ax
aterrar	n	ax - t ax - rr a1
transvasament	n	t r ax n z - B ax - z ax - m e1 n
enginyer	n	ax n - Z i - J e1
adjudicació	n	ax d - Z u - D i - k ax - s i - o1
telefòniques	n	t E - l ax - f O1 - n i - k ax s
trampa	n	t r a1 m - p ax
conveniència	n	k u m - b ax - n i - E1 n - s i - ax
adjudicar	n	ax d - Z u - D i - k a1
contenciós	n	k u n - t ax n - s i - o1 s
expulsat	n	ax k s - p u l - s a1 t
abonats	n	ax - B u - n a1 t s
formalment	n	f u rr - m a l - m e1 n
bancària	n	b ax N - k a1 - r i - ax
presentador	n	p r ax - z ax n - t ax - D o1
assessors	n	ax - s ax - s o1 s
matrícula	n	m ax - t r i1 - k u - l ax
pancarta	n	p ax N - k a1 rr - t ax
carrils	n	k ax - rr i1 l s
televisiu	n	t ax - l ax - B i - z i1 uw
supervivents	n	s u - p ax r - B i - B e1 n s
brutal	n	b r u - t a1 l
diagnòstic	n	d i - ax g - n O1 s - t i k
constància	n	k u n s - t a1 n - s i - ax
ambiciós	n	ax m - b i - s i - o1 s
invertirà	n	i m - b ax rr - t i - r a1
pilar	n	p i - l a1
invitació	n	i m - b i - t ax - s i - o1
barril	n	b ax - rr i1 l
conquistar	n	k u N - k i s - t a1
pistola	n	p i s - t O1 - l ax
cúbics	n	k u1 - B i k s
embargament	n	ax m - b ax r - G ax - m e1 n
nazi	n	n a1 - z i
remetre	n	rr ax - m E1 - t r ax
argumenta	n	ax r - G u - m e1 n - t ax
indult	n	i n - d u1 l
defensors	n	d ax - f ax n - s o1 s
excap	n	E k s - k a1 p
editat	n	ax - D i - t a1 t
cotitzacions	n	k u - t i d - z ax - s i - o1 n s
furgoneta	n	f u r - G u - n E1 - t ax
màfies	n	m a1 - f i - ax s
independentistes	n	i n - d ax - p ax n - d ax n - t i1 s - t ax s
aparentment	n	ax - p ax - r e m - m e1 n
bicicleta	n	b i - s i - k l E1 - t ax
acta	n	a1 k - t ax
blanc-i-blau	n	b l a - N i - B l a1 uw
guionista	n	g i - u - n i1 s - t ax
monopoli	n	m u - n u - p O1 - l i
amant	n	ax - m a1 n
suspens	n	s u s - p E1 n s
natal	n	n ax - t a1 l
bilió	n	b i - l i - o1
desafiament	n	d ax - z ax - f i - ax - m e1 n
paramilitars	n	p ax - r ax - m i - l i - t a1 s
incapacitat	n	i N - k ax - p ax - s i - t a1 t
rumb	n	rr u1 m
narra	n	n a1 - rr ax
disparat	n	d i s - p ax - r a1 t
disputat	n	d i s - p u - t a1 t
diplomàtiques	n	d i - p l u - m a1 - t i - k ax s
informàtics	n	i m - f u rr - m a1 - t i k s
independentista	n	i n - d ax - p ax n - d ax n - t i1 s - t ax
pivot	n	p i - B O1 t
pantalles	n	p ax n - t a1 - L ax s
firmants	n	f i rr - m a1 n s
lleugerament	n	L ax uw - Z e - r ax - m e1 n
escassetat	n	ax s - k ax - s ax - t a1 t
últimament	n	u l - t i - m ax - m e1 n
presentadora	n	p r ax - z ax n - t ax - D o1 - r ax
afluència	n	ax - f l u - E1 n - s i - ax
descartat	n	d ax s - k ax rr - t a1 t
extracte	n	ax k s - t r a1 k - t ax
trencament	n	t r ax N - k ax - m e1 n
delegada	n	d ax - l ax - G a1 - D ax
violacions	n	b i - u - l ax - s i - o1 n s
progressista	n	p r u - G r ax - s i1 s - t ax
abonar	n	ax - B u - n a1
aspiracions	n	ax s - p i - r ax - s i - o1 n s
tripulació	n	t r i - p u - l ax - s i - o1
suïssa	n	s u - i1 - s ax
vídeos	n	b i1 - D e - o s
increïble	n	i N - k r ax - i1 b - b l ax
arquebisbe	n	ax rr - k ax - B i1 z - B ax
funeral	n	f u - n ax - r a1 l
tortura	n	t u rr - t u1 - r ax
pròrroga	n	p r O1 - rr u - G ax
processats	n	p r u - s ax - s a1 t s
prioritats	n	p r i - u - r i - t a1 t s
prestigiós	n	p r ax s - t i - Z i - o1 s
urbanístic	n	u r - B ax - n i1 s - t i k
orgullós	n	u r - G u - L o1 s
gastar	n	g ax s - t a1
abertzale	n	ax - B ax rr d - z a1 - l ax
andalusa	n	ax n - d ax - l u1 - z ax
homosexuals	n	u - m u - z ax k - s u - a1 l s
bin	n	b i1 n
col·lega	n	k u - l E1 - G ax
tramvia	n	t r ax m - b i1 - ax
actrius	n	ax k - t r i1 uw s
auditori	n	ax uw - D i - t O1 - r i
pilotes	n	p i - l O1 - t ax s
promotor	n	p r u - m u - t o1
finlandès	n	f i n - l ax n - d E1 s
respectuosos	n	rr ax s - p ax k - t u - o1 - z u s
genocidi	n	Z ax - n u - s i1 - D i
divisa	n	d i - B i1 - z ax
ridícul	n	rr i - D i1 - k u l
culminar	n	k u l - m i - n a1
parcialment	n	p ax rr - s i - a l - m e1 n
fre	n	f r E1
decepció	n	d ax - s ax p - s i - o1
desconfiança	n	d ax s - k u m - f i - a1 n - s ax
lesionat	n	l ax - z i - u - n a1 t
ambulància	n	ax m - b u - l a1 n - s i - ax
palestina	n	p ax - l ax s - t i1 - n ax
dama	n	d a1 - m ax
sol·licita	n	s u - l i - s i1 - t ax
africà	n	ax - f r i - k a1
nos	n	n o1 s
reclamació	n	rr ax - k l ax - m ax - s i - o1
mesquita	n	m ax s - k i1 - t ax
contribuents	n	k u n - t r i - B u - e1 n s
consultar	n	k u n - s u l - t a1
ambaixada	n	ax m - b ax - S a1 - D ax
biografia	n	b i - u - G r ax - f i1 - ax
asturià	n	ax s - t u - r i - a1
divorci	n	d i - B O1 rr - s i
autora	n	ax uw - t o1 - r ax
rebel	n	rr ax - B E1 l
constructora	n	k u n s - t r u k - t o1 - r ax
toro	n	t O1 - r u
concursants	n	k u N - k u rr - s a1 n s
embarcació	n	ax m - b ax rr - k ax - s i - o1
escenografia	n	ax - s ax - n u - G r ax - f i1 - ax
fractura	n	f r ax k - t u1 - r ax
quadros	n	k w a1 - D r u s
presenciar	n	p r ax - z ax n - s i - a1
profundament	n	p r u - f u n - d ax - m e1 n
terratrèmol	n	t ax - rr ax - t r E1 - m u l
turc	n	t u1 rr k
expulsar	n	ax k s - p u l - s a1
pal·liar	n	p ax - l i - a1
pànic	n	p a1 - n i k
patrulla	n	p ax - t r u1 - L ax
agredir	n	ax - G r ax - D i1
discogràfica	n	d i s - k u - G r a1 - f i - k ax
contractat	n	k u n - t r ax k - t a1 t
raça	n	rr a1 - s ax
setge	n	s e1 d - Z ax
laborista	n	l ax - B u - r i1 s - t ax
colombià	n	k u - l u m - b i - a1
plom	n	p l o1 m
mina	n	m i1 - n ax
fantàstic	n	f ax n - t a1 s - t i k
golejador	n	g u - l ax - Z ax - D o1
obertament	n	u - B E rr - t ax - m e1 n
competicions	n	k u m - p ax - t i - s i - o1 n s
operador	n	u - p ax - r ax - D o1
inclusió	n	i N - k l u - z i - o1
inesperada	n	i - n ax s - p ax - r a1 - D ax
qüestionar	n	k w ax s - t i - u - n a1
mil·lenni	n	m i - l E1 n - n i
humanitàries	n	u - m ax - n i - t a1 - r i - ax s
porcs	n	p O1 rr k s
immobles	n	i m - m O1 b - b l ax s
atletes	n	ax l - l E1 - t ax s
esborrany	n	ax z - B u - rr a1 J
criminals	n	k r i - m i - n a1 l s
pacífica	n	p ax - s i1 - f i - k ax
tecnològics	n	t ax g - n u - l O1 - Z i k s
mobilitzar	n	m u - B i - l i d - z a1
diplomàtica	n	d i - p l u - m a1 - t i - k ax
pantalons	n	p ax n - t ax - l o1 n s
federals	n	f ax - D ax - r a1 l s
tramitació	n	t r ax - m i - t ax - s i - o1
normalment	n	n u rr - m a l - m e1 n
petroleres	n	p ax - t r u - l e1 - r ax s
dissenyador	n	d i - s ax - J ax - D o1
violar	n	b i - u - l a1
catàleg	n	k ax - t a1 - l ax k
negociant	n	n ax - G u - s i - a1 n
dotació	n	d u - t ax - s i - o1
rendible	n	rr ax n - d i1 b - b l ax
acolliment	n	ax - k u - L i - m e1 n
míting	n	m i1 - t i N
plataformes	n	p l ax - t ax - f o1 rr - m ax s
questa	n	k e1 s - t ax
gratis	n	g r a1 - t i s
viària	n	b i - a1 - r i - ax
passaport	n	p a - s ax - p O1 rr t
holandesos	n	u - l ax n - d E1 - z u s
simpatitzants	n	s i m - p ax - t i d - z a1 n s
prostitució	n	p r u s - t i - t u - s i - o1
deporte	n	d ax - p O1 rr - t ax
arxius	n	ax rr - S i1 uw s
sintonia	n	s i n - t u - n i1 - ax
aplaudir	n	ax - p l ax uw - D i1
advocada	n	ax d - b u - k a1 - D ax
perjudicar	n	p ax rr - Z u - D i - k a1
federacions	n	f ax - D ax - r ax - s i - o1 n s
blues	n	b l u1 - ax s
escultura	n	ax s - k u l - t u1 - r ax
menyspreu	n	m E J s - p r E1 uw
empatar	n	ax m - p ax - t a1
reelecció	n	rr e - ax - l ax k - s i - o1
marroquina	n	m ax - rr u - k i1 - n ax
tardar	n	t ax r - D a1
expectació	n	ax k s - p ax k - t ax - s i - o1
racistes	n	rr ax - s i1 s - t ax s
regals	n	rr ax - G a1 l s
racista	n	rr ax - s i1 s - t ax
torero	n	t u - r e1 - r u
culpar	n	k u l - p a1
turista	n	t u - r i1 s - t ax
moderació	n	m u - D ax - r ax - s i - o1
cubana	n	k u - B a1 - n ax
atleta	n	ax l - l E1 - t ax
encapçalada	n	ax N - k ax p - s ax - l a1 - D ax
borsària	n	b u rr - s a1 - r i - ax
aficionat	n	ax - f i - s i - u - n a1 t
informativa	n	i m - f u rr - m ax - t i1 - B ax
dopatge	n	d u - p a1 d - Z ax
ànims	n	a1 - n i m s
oblit	n	u - B l i1 t
màgia	n	m a1 - Z i - ax
impunitat	n	i m - p u - n i - t a1 t
ferir	n	f ax - r i1
lar	n	l a1 rr
opositor	n	u - p u - z i - t o1
arxiu	n	ax rr - S i1 uw
factoria	n	f ax k - t u - r i1 - ax
escorta	n	ax s - k o1 rr - t ax
descarten	n	d ax s - k a1 rr - t ax n
arrestats	n	ax - rr ax s - t a1 t s
franquista	n	f r ax N - k i1 s - t ax
retallar	n	rr ax - t ax - L a1
pròximament	n	p r O k - s i - m ax - m e1 n
prosseguir	n	p r u - s ax - G i1
preparatius	n	p r ax - p ax - r ax - t i1 uw s
handbol	n	ax n d - b O1 l
reafirmar	n	rr e - ax - f i rr - m a1
emocions	n	ax - m u - s i - o1 n s
aixecament	n	ax - S ax - k ax - m e1 n
asil	n	ax - z i1 l
matança	n	m ax - t a1 n - s ax
guanyadora	n	g w ax - J ax - D o1 - r ax
pensionistes	n	p ax n - s i - u - n i1 s - t ax s
tripulants	n	t r i - p u - l a1 n s
apel·lar	n	ax - p ax - l a1
reclamacions	n	rr ax - k l ax - m ax - s i - o1 n s
delegacions	n	d ax - l ax - G ax - s i - o1 n s
campions	n	k ax m - p i - o1 n s
vinculació	n	b i N - k u - l ax - s i - o1
paral·lelament	n	p ax - r ax - l E - l ax - m e1 n
desallotjar	n	d ax - z ax - L u d - Z a1
cubans	n	k u - B a1 n s
espacial	n	ax s - p ax - s i - a1 l
derbi	n	d E1 r - B i
laboratoris	n	l ax - B u - r ax - t O1 - r i s
fonamentalment	n	f u - n ax - m ax n - t a l - m e1 n
filials	n	f i - l i - a1 l s
arrestat	n	ax - rr ax s - t a1 t
inhabilitació	n	i - n ax - B i - l i - t ax - s i - o1
bus	n	b u1 s
ballarins	n	b ax - L ax - r i1 n s
còmic	n	k O1 - m i k
transportistes	n	t r ax n s - p u rr - t i1 s - t ax s
granja	n	g r a1 n - Z ax
taxistes	n	t ax k - s i1 s - t ax s
al·legar	n	ax - l ax - G a1
preventiva	n	p r ax - B ax n - t i1 - B ax
recomanacions	n	rr ax - k u - m ax - n ax - s i - o1 n s
mandatari	n	m ax n - d ax - t a1 - r i
agressors	n	ax - G r ax - s o1 s
prestació	n	p r ax s - t ax - s i - o1
voreres	n	b u - r e1 - r ax s
responsabilitzar	n	rr ax s - p u n - s ax - B i - l i d - z a1
legalment	n	l ax - G a l - m e1 n
greument	n	g r e uw - m e1 n
aus	n	a1 uw s
desacord	n	d ax - z ax - k O1 rr t
desenllaç	n	d ax - z ax J - L a1 s
argentins	n	ax rr - Z ax n - t i1 n s
taquilla	n	t ax - k i1 - L ax
exhibeix	n	ax g - z i - B E1 S
granges	n	g r a1 n - Z ax s
olímpica	n	u - l i1 m - p i - k ax
barcelonista	n	b ax rr - s ax - l u - n i1 s - t ax
explosiu	n	ax k s - p l u - z i1 uw
vestuari	n	b ax s - t u - a1 - r i
concessionària	n	k u n - s ax - s i - u - n a1 - r i - ax
cotitzar	n	k u - t i d - z a1
inaugural	n	i - n ax uw - G u - r a1 l
cobrament	n	k u - B r ax - m e1 n
plus	n	p l u1 s
guardons	n	g w ax r - D o1 n s
relatar	n	rr ax - l ax - t a1
reconciliació	n	rr ax - k u n - s i - l i - ax - s i - o1
mesa	n	m E1 - z ax
facturar	n	f ax k - t u - r a1
recepció	n	rr ax - s ax p - s i - o1
txetxens	n	tS ax t - S E1 n s
enderrocar	n	ax n - d ax - rr u - k a1
insults	n	i n - s u1 l s
màrqueting	n	m a1 rr - k ax - t i N
pressupostari	n	p r ax - s u - p u s - t a1 - r i
beneficia	n	b ax - n ax - f i - s i1 - ax
bancàries	n	b ax N - k a1 - r i - ax s
disturbis	n	d i s - t u1 r - B i s
cognoms	n	k u g - n O1 m s
irlandès	n	i rr - l ax n - d E1 s
coordinar	n	k u - u r - D i - n a1
addicionals	n	ax d - d i - s i - u - n a1 l s
escàndols	n	ax s - k a1 n - d u l s
arrasar	n	ax - rr ax - z a1
casualitat	n	k ax - z u - ax - l i - t a1 t
bombardeig	n	b u m - b ax r - D E1 tS
revalorització	n	rr ax - B ax - l u - r i d - z ax - s i - o1
cinematogràfic	n	s i - n ax - m ax - t u - G r a1 - f i k
embarassada	n	ax m - b ax - r ax - s a1 - D ax
podi	n	p o1 - D i
veïnals	n	b ax - i - n a1 l s
unànime	n	u - n a1 - n i - m ax
econòmicament	n	ax - k u - n O - m i - k ax - m e1 n
convenció	n	k u m - b ax n - s i - o1
barat	n	b ax - r a1 t
anualment	n	ax - n u - a l - m e1 n
avançament	n	ax - B ax n - s ax - m e1 n
afores	n	ax - f O1 - r ax s
empresonat	n	ax m - p r ax - z u - n a1 t
okupes	n	u - k u1 - p ax s
embaràs	n	ax m - b ax - r a1 s
propiciar	n	p r u - p i - s i - a1
comboi	n	k u m - b O1 j
rendes	n	rr e1 n - d ax s
prolongació	n	p r u - l u N - g ax - s i - o1
espionatge	n	ax s - p i - u - n a1 d - Z ax
evidentment	n	ax - B i - D e m - m e1 n
plató	n	p l ax - t o1
maniobres	n	m ax - n i - O1 - B r ax s
lluir	n	L u - i1
asseguradora	n	ax - s ax - G u - r ax - D o1 - r ax
ostatges	n	u s - t a1 d - Z ax s
aterratge	n	ax - t ax - rr a1 d - Z ax
compradors	n	k u m - p r ax - D o1 s
grada	n	g r a1 - D ax
haixix	n	ax - S i1 s
ulleres	n	u - L e1 - r ax s
indi	n	i1 n - d i
compatriota	n	k u m - p ax - t r i - O1 - t ax
albanesa	n	ax l - B ax - n E1 - z ax
recessió	n	rr ax - s ax - s i - o1
mediació	n	m ax - D i - ax - s i - o1
consultats	n	k u n - s u l - t a1 t s
bogeria	n	b u - Z ax - r i1 - ax
sequera	n	s ax - k e1 - r ax
paralitzar	n	p ax - r ax - l i d - z a1
desacceleració	n	d ax - z ax k - s ax - l ax - r ax - s i - o1
injust	n	i n - Z u1 s t
afganesos	n	ax v - G ax - n E1 - z u s
caravana	n	k ax - r ax - B a1 - n ax
bancaris	n	b ax N - k a1 - r i s
adquisitiu	n	ax t - k i - z i - t i1 uw
cines	n	s i1 - n ax s
salarials	n	s ax - l ax - r i - a1 l s
historia	n	i s - t u - r i1 - ax
processament	n	p r u - s ax - s ax - m e1 n
iugoslava	n	y u - G u z - l a1 - B ax
mexicana	n	m ax k - s i - k a1 - n ax
muntatges	n	m u n - t a1 d - Z ax s
retallades	n	rr ax - t ax - L a1 - D ax s
secta	n	s E1 k - t ax
liderar	n	l i - D ax - r a1
cultiu	n	k u l - t i1 uw
sacrifici	n	s ax - k r i - f i1 - s i
incompliment	n	i N - k O m - p l i - m e1 n
negocia	n	n ax - G u - s i1 - ax
fàcilment	n	f a - s i l - m e1 n
segrestadors	n	s ax - G r ax s - t ax - D o1 s
disponibles	n	d i s - p u - n i1 b - b l ax s
capella	n	k ax - p e1 - L ax
domèstica	n	d u - m E1 s - t i - k ax
talibà	n	t ax - l i - B a1
dialogar	n	d i - ax - l u - G a1
afganès	n	ax v - G ax - n E1 s
vaca	n	b a1 - k ax
arques	n	a1 rr - k ax s
abstenir	n	ax p s - t ax - n i1
gasolineres	n	g ax - z u - l i - n e1 - r ax s
comandaments	n	k u - m ax n - d ax - m e1 n s
mensual	n	m ax n - s u - a1 l
mines	n	m i1 - n ax s
segrestat	n	s ax - G r ax s - t a1 t
cognom	n	k u g - n O1 m
militància	n	m i - l i - t a1 n - s i - ax
graella	n	g r ax - e1 - L ax
llàstima	n	L a1 s - t i - m ax
editorials	n	ax - D i - t u - r i - a1 l s
protagonitzen	n	p r u - t ax - G u - n i1 d - z ax n
quest	n	k e1 s t
regularització	n	rr ax - G u - l ax - r i d - z ax - s i - o1
excessivament	n	ax k - s ax - s i - B ax - m e1 n
inaugurat	n	i - n ax uw - G u - r a1 t
incentius	n	i n - s ax n - t i1 uw s
subsaharians	n	s u p - s ax - ax - r i - a1 n s
grip	n	g r i1 p
enderrocament	n	ax n - d ax - rr u - k ax - m e1 n
supermercats	n	s u - p ax rr - m ax rr - k a1 t s
col·lisió	n	k u - l i - z i - o1
soledat	n	s u - l ax - D a1 t
recompte	n	rr ax - k o1 m - t ax
envergadura	n	ax m - b ax r - G ax - D u1 - r ax
comercialització	n	k u - m ax rr - s i - ax - l i d - z ax - s i - o1
inaugura	n	i - n ax uw - G u1 - r ax
xinesos	n	S i - n E1 - z u s
custòdia	n	k u s - t O1 - D i - ax
tradicionalment	n	t r ax - D i - s i - u - n a l - m e1 n
malson	n	m a l - s O1 n
blanc-i-vermell	n	b l a - N i - B ax rr - m E1 L
inacceptable	n	i - n ax k - s ax p - t a1 b - b l ax
lidera	n	l i - D e1 - r ax
precarietat	n	p r e - k ax - r i - ax - t a1 t
infanta	n	i m - f a1 n - t ax
protagonitza	n	p r u - t ax - G u - n i1 d - z ax
desallotjament	n	d ax - z ax - L u d - Z ax - m e1 n
pastera	n	p ax s - t e1 - r ax
gravacions	n	g r ax - B ax - s i - o1 n s
conte	n	k o1 n - t ax
durament	n	d u - r ax - m e1 n
pugna	n	p u1 g - n ax
convergents	n	k u m - b ax rr - Z e1 n s
islàmic	n	i z - l a1 - m i k
ria	n	rr i1 - ax
arbitratge	n	ax r - B i - t r a1 d - Z ax
armament	n	ax rr - m ax - m e1 n
flexibilitat	n	f l ax k - s i - B i - l i - t a1 t
penebista	n	p ax - n ax - B i1 s - t ax
rècords	n	rr E1 - k u rr s
naturalment	n	n ax - t u - r a l - m e1 n
masculí	n	m ax s - k u - l i1
tancs	n	t a1 N s
vigilants	n	b i - Z i - l a1 n s
operaris	n	u - p ax - r a1 - r i s
detinguda	n	d ax - t i N - g u1 - D ax
pressupostària	n	p r ax - s u - p u s - t a1 - r i - ax
narcotràfic	n	n ax rr - k u - t r a1 - f i k
boví	n	b u - B i1
fotògraf	n	f u - t O1 - G r ax f
encreuament	n	ax N - k r ax - w ax - m e1 n
àmpliament	n	a m - p l i - ax - m e1 n
relata	n	rr ax - l a1 - t ax
opositors	n	u - p u - z i - t o1 s
encapçalat	n	ax N - k ax p - s ax - l a1 t
infracció	n	i m - f r ax k - s i - o1
samarretes	n	s ax - m ax - rr E1 - t ax s
barrils	n	b ax - rr i1 l s
implantar	n	i m - p l ax n - t a1
correctament	n	k u - rr E k - t ax - m e1 n
xilens	n	S i - l E1 n s
resident	n	rr ax - z i - D e1 n
tecnològic	n	t ax g - n u - l O1 - Z i k
passarel·la	n	p ax - s ax - r E1 - l ax
àntrax	n	a1 n - t r ax k s
abocament	n	ax - B u - k ax - m e1 n
magnat	n	m ax g - n a1 t
esportista	n	ax s - p u rr - t i1 s - t ax
estrenat	n	ax s - t r ax - n a1 t
runa	n	rr u1 - n ax
globalització	n	g l u - B ax - l i d - z ax - s i - o1
urbanisme	n	u r - B ax - n i1 z - m ax
divises	n	d i - B i1 - z ax s
alinear	n	ax - l i - n e - a1
promotora	n	p r u - m u - t o1 - r ax
patent	n	p ax - t e1 n
sobte	n	s o1 p - t ax
comissaris	n	k u - m i - s a1 - r i s
tramitar	n	t r ax - m i - t a1
restablir	n	rr ax s - t ax b - b l i1
disponible	n	d i s - p u - n i1 b - b l ax
immobiliari	n	i m - m u - B i - l i - a1 - r i
grua	n	g r u1 - ax
consignes	n	k u n - s i1 g - n ax s
operadores	n	u - p ax - r ax - D o1 - r ax s
belgues	n	b E1 l - G ax s
alcoholèmia	n	ax l - k u - u - l E1 - m i - ax
provocació	n	p r u - B u - k ax - s i - o1
festiu	n	f ax s - t i1 uw
inspiració	n	i n s - p i - r ax - s i - o1
ratificat	n	rr ax - t i - f i - k a1 t
emfatitzar	n	ax m - f ax - t i d - z a1
còpia	n	k O1 - p i - ax
informal	n	i m - f u rr - m a1 l
consensuar	n	k u n - s ax n - s u - a1
pegar	n	p ax - G a1
físicament	n	f i - z i - k ax - m e1 n
satèl·lit	n	s ax - t E1 - l i t
gitanos	n	Z i - t a1 - n u s
discreció	n	d i s - k r ax - s i - o1
cansament	n	k ax n - s ax - m e1 n
depuradora	n	d ax - p u - r ax - D o1 - r ax
festivals	n	f ax s - t i - B a1 l s
descomptes	n	d ax s - k o1 m - t ax s
reclusos	n	rr ax - k l u1 - z u s
comissària	n	k u - m i - s a1 - r i - ax
embarcacions	n	ax m - b ax rr - k ax - s i - o1 n s
intercanviar	n	i n - t ax rr - k ax m - b i - a1
gallecs	n	g ax - L E1 k s
saudita	n	s ax uw - D i1 - t ax
mossos	n	m o1 - s u s
campament	n	k ax m - p ax - m e1 n
marató	n	m ax - r ax - t o1
beneficiat	n	b ax - n ax - f i - s i - a1 t
reportatges	n	rr ax - p u rr - t a1 d - Z ax s
prioritari	n	p r i - u - r i - t a1 - r i
injustícia	n	i n - Z u s - t i1 - s i - ax
periodisme	n	p ax - r i - u - D i1 z - m ax
magistrada	n	m ax - Z i s - t r a1 - D ax
proliferació	n	p r u - l i - f ax - r ax - s i - o1
emigrants	n	ax - m i - G r a1 n s
islam	n	i z - l a1 m
traspassar	n	t r ax s - p ax - s a1
coordinadora	n	k u - u r - D i - n ax - D o1 - r ax
campus	n	k a1 m - p u s
taxista	n	t ax k - s i1 s - t ax
austríaca	n	ax uw s - t r i1 - ax - k ax
saldo	n	s a1 l - d u
consultades	n	k u n - s u l - t a1 - D ax s
adversaris	n	ax d - b ax rr - s a1 - r i s
contenció	n	k u n - t ax n - s i - o1
boicot	n	b u j - k O1 t
reparar	n	rr ax - p ax - r a1
postures	n	p u s - t u1 - r ax s
acomiadaments	n	ax - k u - m i - ax - D ax - m e1 n s
lliurement	n	L i uw - r ax - m e1 n
vaticinar	n	b ax - t i - s i - n a1
desfilar	n	d ax s - f i - l a1
inspeccions	n	i n s - p ax k - s i - o1 n s
descompte	n	d ax s - k o1 m - t ax
falsedat	n	f ax l - s ax - D a1 t
benvinguda	n	b e m - b i N - g u1 - D ax
estrictament	n	ax s - t r i k - t ax - m e1 n
selectivitat	n	s ax - l ax k - t i - B i - t a1 t
penebistes	n	p ax - n ax - B i1 s - t ax s
firmades	n	f i rr - m a1 - D ax s
pakistanès	n	p ax - k i s - t ax - n E1 s
pastilles	n	p ax s - t i1 - L ax s
instrueix	n	i n s - t r u - E1 S
detingudes	n	d ax - t i N - g u1 - D ax s
conquista	n	k u N - k i1 s - t ax
organitzador	n	u r - G ax - n i d - z ax - D o1
aules	n	a1 uw - l ax s
ajust	n	ax - Z u1 s t
pronòstic	n	p r u - n O1 s - t i k
taxis	n	t a1 k - s i s
antecessor	n	ax n - t ax - s ax - s o1
auge	n	a1 uw - Z ax
artefactes	n	ax rr - t ax - f a1 k - t ax s
venedors	n	b ax - n ax - D o1 s
vacuna	n	b ax - k u1 - n ax
oxigen	n	u k - s i1 - Z ax n
rendir	n	rr ax n - d i1
rànquing	n	rr a1 N - k i N
rescissió	n	rr ax - s i - s i - o1
governants	n	g u - B ax rr - n a1 n s
eradicar	n	ax - r ax - D i - k a1
vial	n	b i - a1 l
pallissa	n	p ax - L i1 - s ax
serenitat	n	s ax - r ax - n i - t a1 t
complicar	n	k u m - p l i - k a1
generositat	n	Z ax - n ax - r u - z i - t a1 t
importacions	n	i m - p u rr - t ax - s i - o1 n s
censurar	n	s ax n - s u - r a1
segrestats	n	s ax - G r ax s - t a1 t s
enrenou	n	ax n - rr ax - n O1 uw
encaputxats	n	ax N - k ax - p u t - S a1 t s
mansió	n	m ax n - s i - o1
visual	n	b i - z u - a1 l
recepta	n	rr ax - s e1 p - t ax
augurar	n	ax uw - G u - r a1
acer	n	ax - s e1 rr
ambulàncies	n	ax m - b u - l a1 n - s i - ax s
xinesa	n	S i - n E1 - z ax
conjuntura	n	k u n - Z u n - t u1 - r ax
sigles	n	s i1 - G l ax s
degà	n	d ax - G a1
allotjament	n	ax - L u d - Z ax - m e1 n
cruel	n	k r u - E1 l
compatriotes	n	k u m - p ax - t r i - O1 - t ax s
contrarestar	n	k O n - t r ax - rr ax s - t a1
progressistes	n	p r u - G r ax - s i1 s - t ax s
cultius	n	k u l - t i1 uw s
interanual	n	i n - t ax - r ax - n u - a1 l
doblatge	n	d u b - b l a1 d - Z ax
llegat	n	L ax - G a1 t
horror	n	u - rr o1 rr
reprotxar	n	rr ax - p r u t - S a1
retre	n	rr E1 - t r ax
borroka	n	b u - rr o1 - k ax
tecnològica	n	t ax g - n u - l O1 - Z i - k ax
xantatge	n	S ax n - t a1 d - Z ax
docents	n	d u - s e1 n s
eurodiputat	n	E uw - r u - D i - p u - t a1 t
autòpsia	n	ax uw - t O1 p - s i - ax
negligència	n	n ax - G l i - Z E1 n - s i - ax
letal	n	l ax - t a1 l
combatents	n	k u m - b ax - t e1 n s
rang	n	rr a1 N
golejada	n	g u - l ax - Z a1 - D ax
guanyadors	n	g w ax - J ax - D o1 s
auxili	n	ax uw k - s i1 - l i
milionari	n	m i - l i - u - n a1 - r i
exconseller	n	E k s - k u n - s ax - L e1
successos	n	s u k - s e1 - s u s
destituït	n	d ax s - t i - t u - i1 t
especialitat	n	ax s - p ax - s i - ax - l i - t a1 t
terminals	n	t ax rr - m i - n a1 l s
firal	n	f i - r a1 l
adversari	n	ax d - b ax rr - s a1 - r i
infart	n	i m - f a1 rr t
pesquer	n	p ax s - k e1
justament	n	Z u s - t ax - m e1 n
enterrament	n	ax n - t ax - rr ax - m e1 n
ministeris	n	m i - n i s - t E1 - r i s
anècdota	n	ax - n E1 g - d u - t ax
mobiliari	n	m u - B i - l i - a1 - r i
campiona	n	k ax m - p i - o1 - n ax
expulsats	n	ax k s - p u l - s a1 t s
professorat	n	p r u - f ax - s u - r a1 t
indemnitzar	n	i n - d ax m - n i d - z a1
voluntàriament	n	b u - l u n - t a - r i - ax - m e1 n
proveïdors	n	p r u - B ax - i - D o1 s
anticipades	n	ax n - t i - s i - p a1 - D ax s
historial	n	i s - t u - r i - a1 l
súper	n	s u1 - p ax rr
impotència	n	i m - p u - t E1 n - s i - ax
retrets	n	rr ax - t r e1 t s
vorera	n	b u - r e1 - r ax
remès	n	rr ax - m E1 s
trofeu	n	t r u - f E1 uw
loteria	n	l u - t ax - r i1 - ax
desviament	n	d ax z - B i - ax - m e1 n
urani	n	u - r a1 - n i
anonimat	n	ax - n u - n i - m a1 t
democristià	n	d E - m u - k r i s - t i - a1
entrenadors	n	ax n - t r ax - n ax - D o1 s
cinturó	n	s i n - t u - r o1
mític	n	m i1 - t i k
kosovar	n	k u - z u - B a1
contrarellotge	n	k O n - t r ax - rr ax - L O1 d - Z ax
sinistralitat	n	s i - n i s - t r ax - l i - t a1 t
túnels	n	t u1 - n ax l s
precaució	n	p r ax - k ax uw - s i - o1
legitimitat	n	l ax - Z i - t i - m i - t a1 t
tropa	n	t r o1 - p ax
aparcaments	n	ax - p ax rr - k ax - m e1 n s
admiració	n	ax d - m i - r ax - s i - o1
diplomàtics	n	d i - p l u - m a1 - t i k s
festius	n	f ax s - t i1 uw s
bolcar	n	b u l - k a1
medalles	n	m ax - D a1 - L ax s
tornejos	n	t u rr - n E1 - Z u s
cuidar	n	k u j - D a1
íntegrament	n	i n - t ax - G r ax - m e1 n
ballarí	n	b ax - L ax - r i1
sueca	n	s u - E1 - k ax
exdona	n	E g z - D O1 - n ax
ira	n	i1 - r ax
temporalment	n	t ax m - p u - r a l - m e1 n
teràpia	n	t ax - r a1 - p i - ax
himne	n	i1 m - n ax
investigant	n	i m - b ax s - t i - G a1 n
exvicepresident	n	E g z - B i - s ax - p r ax - z i - D e1 n
secreta	n	s ax - k r e1 - t ax
comptabilitat	n	k u m - t ax - B i - l i - t a1 t
animació	n	ax - n i - m ax - s i - o1
inaugurarà	n	i - n ax uw - G u - r ax - r a1
factures	n	f ax k - t u1 - r ax s
desperfectes	n	d ax s - p ax rr - f e1 k - t ax s
blanqueig	n	b l ax N - k E1 tS
sol·licituds	n	s u - l i - s i - t u1 t s
tron	n	t r O1 n
màfia	n	m a1 - f i - ax
contratemps	n	k O n - t r ax - t e1 m s
elegant	n	ax - l ax - G a1 n
llest	n	L e1 s t
correcció	n	k u - rr ax k - s i - o1
kale	n	k a1 - l ax
publicitària	n	p u - B l i - s i - t a1 - r i - ax
competidors	n	k u m - p ax - t i - D o1 s
geni	n	Z E1 - n i
firmada	n	f i rr - m a1 - D ax
gestors	n	Z ax s - t o1 s
especulació	n	ax s - p ax - k u - l ax - s i - o1
coproducció	n	k u - p r u - D u k - s i - o1
kurd	n	k u1 rr t
publicitari	n	p u - B l i - s i - t a1 - r i
top	n	t O1 p
internautes	n	i n - t ax rr - n a1 uw - t ax s
negociadors	n	n ax - G u - s i - ax - D o1 s
islàmics	n	i z - l a1 - m i k s
extres	n	E1 k s - t r ax s
relativament	n	rr ax - l ax - t i - B ax - m e1 n
enfonsament	n	ax m - f u n - z ax - m e1 n
subdirector	n	s u b - d i - r ax k - t o1
globus	n	g l O1 - B u s
clonació	n	k l u - n ax - s i - o1
ajornament	n	ax - Z u rr - n ax - m e1 n
matx	n	m a1 tS
moratòria	n	m u - r ax - t O1 - r i - ax
rellevància	n	rr ax - L ax - B a1 n - s i - ax
teleespectadors	n	t E - l ax s - p ax k - t ax - D o1 s
desgast	n	d ax z - G a1 s t
negociador	n	n ax - G u - s i - ax - D o1
particularment	n	p ax rr - t i - k u - l a rr - m e1 n
intel	n	i n - t E1 l
temàtic	n	t ax - m a1 - t i k
magribí	n	m ax - G r i - B i1
consigna	n	k u n - s i1 g - n ax
reobrir	n	rr ax - u - B r i1
iraquià	n	i - r ax - k i - a1
mediambiental	n	m ax - D i - ax m - b i - ax n - t a1 l
comoditat	n	k u - m u - D i - t a1 t
entramat	n	ax n - t r ax - m a1 t
bàndol	n	b a1 n - d u l
certificat	n	s ax rr - t i - f i - k a1 t
extremadament	n	ax k s - t r ax - m a - D ax - m e1 n
intensificar	n	i n - t ax n - s i - f i - k a1
al·legant	n	ax - l ax - G a1 n
alineació	n	ax - l i - n e - ax - s i - o1
parador	n	p ax - r ax - D o1
contraatac	n	k O n - t r ax - t a1 k
zoo	n	z o1 - o
simpatia	n	s i m - p ax - t i1 - ax
embrions	n	ax m - b r i - o1 n s
votacions	n	b u - t ax - s i - o1 n s
cava	n	k a1 - B ax
afortunadament	n	ax - f u rr - t u - n a - D ax - m e1 n
aparcar	n	ax - p ax rr - k a1
instructor	n	i n s - t r u k - t o1
dissenyadors	n	d i - s ax - J ax - D o1 s
hipoteques	n	i - p u - t E1 - k ax s
antena	n	ax n - t E1 - n ax
integristes	n	i n - t ax - G r i1 s - t ax s
tiroteig	n	t i - r u - t E1 tS
estatus	n	ax s - t a1 - t u s
ministerial	n	m i - n i s - t ax - r i - a1 l
destrossar	n	d ax s - t r u - s a1
embussos	n	ax m - b u1 - s u s
seqüeles	n	s ax - k w E1 - l ax s
islàmica	n	i z - l a1 - m i - k ax
bombardejar	n	b u m - b ax r - D ax - Z a1
asiàtic	n	ax - z i - a1 - t i k
còctels	n	k O1 k - t ax l s
discoteques	n	d i s - k u - t E1 - k ax s
fitxat	n	f i t - S a1 t
incendiar	n	i n - s ax n - d i - a1
absolt	n	ax p - s O1 l t
gasolines	n	g ax - z u - l i1 - n ax s
artilleria	n	ax rr - t i - L ax - r i1 - ax
cerebral	n	s ax - r ax - B r a1 l
necessàriament	n	n ax - s ax - s a - r i - ax - m e1 n
superàvit	n	s u - p ax - r a1 - B i t
bronze	n	b r o1 n - z ax
pasteres	n	p ax s - t e1 - r ax s
grades	n	g r a1 - D ax s
ciclisme	n	s i - k l i1 z - m ax
perjudica	n	p ax rr - Z u - D i1 - k ax
electe	n	ax - l E1 k - t ax
genoma	n	Z ax - n o1 - m ax
expressament	n	ax k s - p r e - s ax - m e1 n
incondicional	n	i N - k u n - d i - s i - u - n a1 l
contributives	n	k u n - t r i - B u - t i1 - B ax s
investigat	n	i m - b ax s - t i - G a1 t
pilars	n	p i - l a1 s
advoca	n	ax d - b o1 - k ax
distanciament	n	d i s - t ax n - s i - ax - m e1 n
innovador	n	i n - n u - B ax - D o1
efectivament	n	ax - f ax k - t i - B ax - m e1 n
esquivar	n	ax s - k i - B a1
apoderar	n	ax - p u - D ax - r a1
firmats	n	f i rr - m a1 t s
convidar	n	k u m - b i - D a1
residencial	n	rr ax - z i - D ax n - s i - a1 l
demora	n	d ax - m o1 - r ax
radicalment	n	rr ax - D i - k a l - m e1 n
bilaterals	n	b i - l ax - t ax - r a1 l s
israelianes	n	i z - rr ax - e - l i - a1 - n ax s
inesperat	n	i - n ax s - p ax - r a1 t
precampanya	n	p r e - k ax m - p a1 - J ax
certament	n	s E rr - t ax - m e1 n
altament	n	a l - t ax - m e1 n
entregarà	n	ax n - t r ax - G ax - r a1
editar	n	ax - D i - t a1
andalusos	n	ax n - d ax - l u1 - z u s
cívic	n	s i1 - B i k
traves	n	t r a1 - B ax s
alcista	n	ax l - s i1 s - t ax
interrogar	n	i n - t ax - rr u - G a1
inestabilitat	n	i - n ax s - t ax - B i - l i - t a1 t
programat	n	p r u - G r ax - m a1 t
certificar	n	s ax rr - t i - f i - k a1
especulacions	n	ax s - p ax - k u - l ax - s i - o1 n s
londinenc	n	l u n - d i - n E1 N
pastilla	n	p ax s - t i1 - L ax
unionistes	n	u - n i - u - n i1 s - t ax s
valentia	n	b ax - l ax n - t i1 - ax
reticències	n	rr ax - t i - s E1 n - s i - ax s
iranià	n	i - r ax - n i - a1
ocultar	n	u - k u l - t a1
massacre	n	m ax - s a1 - k r ax
fibra	n	f i1 - B r ax
xòfer	n	S O1 - f ax
contes	n	k o1 n - t ax s
brigada	n	b r i - G a1 - D ax
oients	n	u - y e1 n s
optimistes	n	u p - t i - m i1 s - t ax s
extremistes	n	ax k s - t r ax - m i1 s - t ax s
activar	n	ax k - t i - B a1
convenciment	n	k u m - b ax n - s i - m e1 n
como	n	k o1 - m u
parquet	n	p ax rr - k E1 t
naufragi	n	n ax uw - f r a1 - Z i
pirates	n	p i - r a1 - t ax s
màgica	n	m a1 - Z i - k ax
kurds	n	k u1 rr s
liquidació	n	l i - k i - D ax - s i - o1
rotund	n	rr u - t u1 n
ferrocarril	n	f ax - rr u - k ax - rr i1 l
cervesa	n	s ax r - B E1 - z ax
antimíssils	n	a n - t i - m i1 - s i l s
confessió	n	k u m - f ax - s i - o1
domèstic	n	d u - m E1 s - t i k
solista	n	s u - l i1 s - t ax
fiscalitat	n	f i s - k ax - l i - t a1 t
extra	n	E1 k s - t r ax
coratge	n	k u - r a1 d - Z ax
pneumàtics	n	p n ax uw - m a1 - t i k s
constantment	n	k u n s - t a m - m e1 n
lentitud	n	l ax n - t i - t u1 t
indagacions	n	i n - d ax - G ax - s i - o1 n s
conclave	n	k u N - k l a1 - B ax
convencional	n	k u m - b ax n - s i - u - n a1 l
logística	n	l u - Z i1 s - t i - k ax
atemptar	n	ax - t ax m - t a1
efectivitat	n	ax - f ax k - t i - B i - t a1 t
croat	n	k r u - a1 t
dedicació	n	d ax - D i - k ax - s i - o1
viaje	n	b i - a1 - Z ax
albanès	n	ax l - B ax - n E1 s
presoners	n	p r ax - z u - n e1 s
creativitat	n	k r e - ax - t i - B i - t a1 t
curar	n	k u - r a1
recomanació	n	rr ax - k u - m ax - n ax - s i - o1
sagnant	n	s ax g - n a1 n
novaiorquès	n	n u - B ax - y u rr - k E1 s
impecable	n	i m - p ax - k a1 b - b l ax
derrotat	n	d ax - rr u - t a1 t
supermercat	n	s u - p ax rr - m ax rr - k a1 t
igualar	n	i - G w ax - l a1
patronat	n	p ax - t r u - n a1 t
acompanyament	n	ax - k u m - p ax - J ax - m e1 n
èmfasi	n	E1 m - f ax - z i
etiqueta	n	ax - t i - k E1 - t ax
lletrats	n	L ax - t r a1 t s
pesants	n	p ax - z a1 n s
capitalització	n	k ax - p i - t ax - l i d - z ax - s i - o1
ubicat	n	u - B i - k a1 t
malversació	n	m a l - B ax rr - s ax - s i - o1
imprudència	n	i m - p r u - D E1 n - s i - ax
autocars	n	ax uw - t u - k a1 rr s
ajornat	n	ax - Z u rr - n a1 t
qüestiona	n	k w ax s - t i - o1 - n ax
australiana	n	ax uw s - t r ax - l i - a1 - n ax
debò	n	d ax - B O1
cautela	n	k ax uw - t E1 - l ax
islamistes	n	i z - l ax - m i1 s - t ax s
magazín	n	m ax - G ax - z i1 n
avaluació	n	ax - B ax - l u - ax - s i - o1
ironitzar	n	i - r u - n i d - z a1
enginyeria	n	ax n - Z i - J ax - r i1 - ax
ajustar	n	ax - Z u s - t a1
nostàlgia	n	n u s - t a1 l - Z i - ax
professionalitat	n	p r u - f ax - s i - u - n ax - l i - t a1 t
jubilat	n	Z u - B i - l a1 t
rotundament	n	rr u - t u n - d ax - m e1 n
planeja	n	p l ax - n E1 - Z ax
encariment	n	ax N - k ax - r i - m e1 n
suborn	n	s u - B o1 rr n
sinistres	n	s i - n i1 s - t r ax s
paratge	n	p ax - r a1 d - Z ax
dinamita	n	d i - n ax - m i1 - t ax
mediador	n	m ax - D i - ax - D o1
contraure	n	k u n - t r a1 uw - r ax
frustrat	n	f r u s - t r a1 t
queixen	n	k E1 - S ax n
currículum	n	k u - rr i1 - k u - l u m
serietat	n	s ax - r i - ax - t a1 t
caixers	n	k ax - S e1 s
porters	n	p u rr - t e1 s
retransmissió	n	rr ax - t r ax n z - m i - s i - o1
cables	n	k a1 b - b l ax s
guarderia	n	g w ax r - D ax - r i1 - ax
injusta	n	i n - Z u1 s - t ax
interrogatori	n	i n - t ax - rr u - G ax - t O1 - r i
pakistanesos	n	p ax - k i s - t ax - n E1 - z u s
lúdic	n	l u1 - D i k
antenes	n	ax n - t E1 - n ax s
clausurar	n	k l ax uw - z u - r a1
discapacitats	n	d i s - k ax - p ax - s i - t a1 t s
certesa	n	s ax rr - t E1 - z ax
sufragis	n	s u - f r a1 - Z i s
ídol	n	i1 - D u l
canari	n	k ax - n a1 - r i
apropiació	n	ax - p r u - p i - ax - s i - o1
debuta	n	d ax - B u1 - t ax
amants	n	ax - m a1 n s
indefinida	n	i n - d ax - f i - n i1 - D ax
arriscar	n	ax - rr i s - k a1
baralles	n	b ax - r a1 - L ax s
escultor	n	ax s - k u l - t o1
infraccions	n	i m - f r ax k - s i - o1 n s
superioritat	n	s u - p ax - r i - u - r i - t a1 t
imputa	n	i m - p u1 - t ax
evacuació	n	ax - B ax - k u - ax - s i - o1
apartament	n	ax - p ax rr - t ax - m e1 n
ferroviària	n	f ax - rr u - B i - a1 - r i - ax
controvèrsia	n	k u n - t r u - B E1 rr - s i - ax
flamant	n	f l ax - m a1 n
desesperació	n	d ax - z ax s - p ax - r ax - s i - o1
ferroviari	n	f ax - rr u - B i - a1 - r i
avantprojecte	n	ax - B a m - p r u - Z e1 k - t ax
asfalt	n	ax s - f a1 l t
legítim	n	l ax - Z i1 - t i m
aposten	n	ax - p O1 s - t ax n
peruà	n	p ax - r u - a1
davanters	n	d ax - B ax n - t e1 s
abusar	n	ax - B u - z a1
dieta	n	d i - E1 - t ax
carburant	n	k ax r - B u - r a1 n
constructor	n	k u n s - t r u k - t o1
oro	n	O1 - r u
auditoria	n	ax uw - D i - t u - r i1 - ax
turmell	n	t u rr - m e1 L
mediàtica	n	m ax - D i - a1 - t i - k ax
fotògrafs	n	f u - t O1 - G r ax f s
commemorar	n	k u m - m ax - m u - r a1
lleialtat	n	L ax - y ax l - t a1 t
borsari	n	b u rr - s a1 - r i
rialles	n	rr i - a1 - L ax s
integral	n	i n - t ax - G r a1 l
tutela	n	t u - t E1 - l ax
canadenc	n	k ax - n ax - D E1 N
òrbita	n	O1 r - B i - t ax
inusual	n	i - n u - z u - a1 l
independentment	n	i n - d ax - p ax n - d e m - m e1 n
mediàtic	n	m ax - D i - a1 - t i k
desfilades	n	d ax s - f i - l a1 - D ax s
secundar	n	s ax - k u n - d a1
tensa	n	t E1 n - s ax
perjudicat	n	p ax rr - Z u - D i - k a1 t
elapé	n	ax - l ax - p e1
prisma	n	p r i1 z - m ax
prostitutes	n	p r u s - t i - t u1 - t ax s
endeutament	n	ax n - d ax uw - t ax - m e1 n
cabina	n	k ax - B i1 - n ax
homicida	n	u - m i - s i1 - D ax
cabuda	n	k ax - B u1 - D ax
solidesa	n	s u - l i - D E1 - z ax
destrosses	n	d ax s - t r O1 - s ax s
llibreria	n	L i - B r ax - r i1 - ax
gratuïtat	n	g r ax - t u - i - t a1 t
algerià	n	ax l - Z ax - r i - a1
collita	n	k u - L i1 - t ax
desconcert	n	d ax s - k u n - s E1 rr t
irregularitat	n	i - rr ax - G u - l ax - r i - t a1 t
coreografia	n	k u - r ax - u - G r ax - f i1 - ax
aval	n	ax - B a1 l
inversor	n	i m - b ax rr - s o1
descàrrega	n	d ax s - k a1 - rr ax - G ax
vincles	n	b i1 N - k l ax s
conducció	n	k u n - d u k - s i - o1
indeguda	n	i n - d ax - G u1 - D ax
cistella	n	s i s - t e1 - L ax
gesta	n	Z e1 s - t ax
nòmina	n	n O1 - m i - n ax
aclaparadora	n	ax - k l ax - p ax - r ax - D o1 - r ax
pistoles	n	p i s - t O1 - l ax s
licitar	n	l i - s i - t a1
nerviosisme	n	n ax r - B i - u - z i1 z - m ax
frontal	n	f r u n - t a1 l
escultures	n	ax s - k u l - t u1 - r ax s
desmarcar	n	d ax z - m ax rr - k a1
unilateral	n	u - n i - l ax - t ax - r a1 l
tranquil·litzar	n	t r ax N - k i - l i d - z a1
perjudicats	n	p ax rr - Z u - D i - k a1 t s
senzillament	n	s ax n - z i - L ax - m e1 n
fatal	n	f ax - t a1 l
apoderat	n	ax - p u - D ax - r a1 t
acústica	n	ax - k u1 s - t i - k ax
gastat	n	g ax s - t a1 t
botes	n	b o1 - t ax s
guionistes	n	g i - u - n i1 s - t ax s
firmarà	n	f i rr - m ax - r a1
tribuna	n	t r i - B u1 - n ax
capturar	n	k ax p - t u - r a1
gallega	n	g ax - L E1 - G ax
desmuntar	n	d ax z - m u n - t a1
arsenal	n	ax rr - s ax - n a1 l
atletisme	n	ax l - l ax - t i1 z - m ax
ambiciosa	n	ax m - b i - s i - o1 - z ax
rectors	n	rr ax k - t o1 s
conviure	n	k u m - b i1 uw - r ax
contundents	n	k u n - t u n - d e1 n s
mestra	n	m E1 s - t r ax
doblar	n	d u b - b l a1
masculina	n	m ax s - k u - l i1 - n ax
audiovisuals	n	ax uw - D i - u - B i - z u - a1 l s
dilema	n	d i - l E1 - m ax
disculpes	n	d i s - k u1 l - p ax s
destituir	n	d ax s - t i - t u - i1
cooperativa	n	k u - u - p ax - r ax - t i1 - B ax
àrbitres	n	a1 r - B i - t r ax s
productores	n	p r u - D u k - t o1 - r ax s
comandos	n	k u - m a1 n - d u s
dissidents	n	d i - s i - D e1 n s
anticipar	n	ax n - t i - s i - p a1
milícies	n	m i - l i1 - s i - ax s
centreesquerra	n	s e n - t r ax s - k E1 - rr ax
ensurt	n	ax n - s u1 rr t
premiat	n	p r ax - m i - a1 t
consecució	n	k u n - s ax - k u - s i - o1
quartet	n	k w ax rr - t E1 t
aforament	n	ax - f u - r ax - m e1 n
exèrcit	n	ax g - z E1 rr - s i t
indis	n	i1 n - d i s
txetxè	n	tS ax t - S E1
falsificació	n	f ax l - s i - f i - k ax - s i - o1
empresonats	n	ax m - p r ax - z u - n a1 t s
patronals	n	p ax - t r u - n a1 l s
perpètua	n	p ax rr - p E1 - t u - ax
ofensiu	n	u - f ax n - s i1 uw
receptes	n	rr ax - s e1 p - t ax s
marginació	n	m ax rr - Z i - n ax - s i - o1
barata	n	b ax - r a1 - t ax
cirurgia	n	s i - r u rr - Z i1 - ax
competitiva	n	k u m - p ax - t i - t i1 - B ax
teatrals	n	t e - ax - t r a1 l s
segrestar	n	s ax - G r ax s - t a1
quarter	n	k w ax rr - t e1
emmarca	n	ax m - m a1 rr - k ax
pronosticar	n	p r u - n u s - t i - k a1
agredit	n	ax - G r ax - D i1 t
senyalització	n	s ax - J ax - l i d - z ax - s i - o1
penitenciari	n	p ax - n i - t ax n - s i - a1 - r i
evacuar	n	ax - B ax - k u - a1
homosexual	n	u - m u - s ax k - s u - a1 l
rondes	n	rr o1 n - d ax s
huracà	n	u - r ax - k a1
gasolinera	n	g ax - z u - l i - n e1 - r ax
apostat	n	ax - p u s - t a1 t
indignat	n	i n - d i g - n a1 t
excanceller	n	E k s - k ax n - s ax - L e1
invent	n	i m - b e1 n
fauna	n	f a1 uw - n ax
gimnàs	n	Z i m - n a1 s
represàlies	n	rr ax - p r ax - z a1 - l i - ax s
egipci	n	ax - Z i1 p - s i
democristians	n	d E - m u - k r i s - t i - a1 n s
condol	n	k u n - d O1 l
penitenciària	n	p ax - n i - t ax n - s i - a1 - r i - ax
directrius	n	d i - r ax k - t r i1 uw s
lesionar	n	l ax - z i - u - n a1
liquidar	n	l i - k i - D a1
teló	n	t ax - l o1
analista	n	ax - n ax - l i1 s - t ax
naturalitat	n	n ax - t u - r ax - l i - t a1 t
amable	n	ax - m a1 b - b l ax
enginyers	n	ax n - Z i - J e1 s
anticorrupció	n	a n - t i - k u - rr u p - s i - o1
legislatiu	n	l ax - Z i z - l ax - t i1 uw
retenció	n	rr ax - t ax n - s i - o1
il·legalment	n	i - l ax - G a l - m e1 n
positivament	n	p u - z i - t i - B ax - m e1 n
jueva	n	Z u - e1 - B ax
nadons	n	n ax - D o1 n s
restaurar	n	rr ax s - t ax uw - r a1
avortament	n	ax - B u rr - t ax - m e1 n
hospitalari	n	u s - p i - t ax - l a1 - r i
ballet	n	b ax - L E1 t
coronar	n	k u - r u - n a1
líquid	n	l i1 - k i t
perjudicial	n	p ax rr - Z u - D i - s i - a1 l
pastís	n	p ax s - t i1 s
reivindica	n	rr ax - i - B i n - d i1 - k ax
exministra	n	E g z - m i - n i1 s - t r ax
entreteniment	n	ax n - t r ax - t ax - n i - m e1 n
excuses	n	ax k s - k u1 - z ax s
pronòstics	n	p r u - n O1 s - t i k s
iugoslaves	n	y u - G u z - l a1 - B ax s
seients	n	s ax - y e1 n s
exjutge	n	E g - Z u1 d - Z ax
asseguradores	n	ax - s ax - G u - r ax - D o1 - r ax s
seminari	n	s ax - m i - n a1 - r i
tòria	n	t O1 - r i - ax
èxode	n	E1 g - z u - D ax
contractats	n	k u n - t r ax k - t a1 t s
retrocedir	n	rr ax - t r u - s ax - D i1
deficient	n	d ax - f i - s i - e1 n
auto	n	a1 uw - t u
palmarès	n	p ax l - m ax - r E1 s
assaltar	n	ax - s ax l - t a1
reg	n	rr e1 k
escocès	n	ax s - k u - s E1 s
promocional	n	p r u - m u - s i - u - n a1 l
clan	n	k l a1 n
sembrar	n	s ax m - b r a1
matrícules	n	m ax - t r i1 - k u - l ax s
negociat	n	n ax - G u - s i - a1 t
cardíaca	n	k ax r - D i1 - ax - k ax
creïble	n	k r ax - i1 b - b l ax
refugiat	n	rr ax - f u - Z i - a1 t
generalment	n	Z ax - n ax - r a l - m e1 n
automobilistes	n	a uw - t u - m u - B i - l i1 s - t ax s
turca	n	t u1 rr - k ax
comprador	n	k u m - p r ax - D o1
escènica	n	ax - s E1 - n i - k ax
pesta	n	p e1 s - t ax
carpa	n	k a1 rr - p ax
barbàrie	n	b ax r - B a1 - r i - ax
bilateral	n	b i - l ax - t ax - r a1 l
inaugurada	n	i - n ax uw - G u - r a1 - D ax
crispació	n	k r i s - p ax - s i - o1
tècnicament	n	t E g - n i - k ax - m e1 n
simultàniament	n	s i - m u l - t a - n i - ax - m e1 n
competitiu	n	k u m - p ax - t i - t i1 uw
alarmant	n	ax - l ax rr - m a1 n
irrompre	n	i - rr o1 m - p r ax
hotelera	n	u - t ax - l e1 - r ax
potestat	n	p u - t ax s - t a1 t
vincular	n	b i N - k u - l a1
pantà	n	p ax n - t a1
segellar	n	s ax - Z ax - L a1
abatut	n	ax - B ax - t u1 t
colombiana	n	k u - l u m - b i - a1 - n ax
aler	n	ax - l e1
garatge	n	g ax - r a1 d - Z ax
farmacèutics	n	f ax rr - m ax - s E1 uw - t i k s
encarar	n	ax N - k ax - r a1
beques	n	b E1 - k ax s
hoquei	n	u - k E1 j
explosions	n	ax k s - p l u - z i - o1 n s
multimilionari	n	m u l - t i - m i - l i - u - n a1 - r i
embarcar	n	ax m - b ax rr - k a1
tecnològiques	n	t ax g - n u - l O1 - Z i - k ax s
divulgar	n	d i - B u l - G a1
doctora	n	d u k - t o1 - r ax
selectiva	n	s ax - l ax k - t i1 - B ax
autoria	n	ax uw - t u - r i1 - ax
apel·lació	n	ax - p ax - l ax - s i - o1
reciclatge	n	rr ax - s i - k l a1 d - Z ax
sacrificar	n	s ax - k r i - f i - k a1
romanès	n	rr u - m ax - n E1 s
assabentar	n	ax - s ax - B ax n - t a1
exiliats	n	ax g - z i - l i - a1 t s
patrocini	n	p ax - t r u - s i1 - n i
minimitzar	n	m i - n i - m i d - z a1
itinerari	n	i - t i - n ax - r a1 - r i
canalitzar	n	k ax - n ax - l i d - z a1
mariners	n	m ax - r i - n e1 s
refugiar	n	rr ax - f u - Z i - a1
metall	n	m ax - t a1 L
cautelar	n	k ax uw - t ax - l a1
diversió	n	d i - B ax rr - s i - o1
reconversió	n	rr ax - k u m - b ax rr - s i - o1
progressivament	n	p r u - G r ax - s i - B ax - m e1 n
desqualificar	n	d ax s - k w ax - l i - f i - k a1
hotelers	n	u - t ax - l e1 s
turcs	n	t u1 rr k s
ciutadanes	n	s i uw - t ax - D a1 - n ax s
addicció	n	ax d - d i k - s i - o1
avantguarda	n	ax - B ax N - g w a1 r - D ax
molest	n	m u - l e1 s t
iugoslaus	n	y u - G u z - l a1 uw s
finalista	n	f i - n ax - l i1 s - t ax
falla	n	f a1 - L ax
domicilis	n	d u - m i - s i1 - l i s
controladors	n	k u n - t r u - l ax - D o1 s
taquilles	n	t ax - k i1 - L ax s
lògicament	n	l O - Z i - k ax - m e1 n
dramaturg	n	d r ax - m ax - t u1 rr k
represàlia	n	rr ax - p r ax - z a1 - l i - ax
econò	n	ax - k u - n O1
sentencia	n	s ax n - t ax n - s i1 - ax
gamma	n	g a1 m - m ax
càmping	n	k a1 m - p i N
sevillà	n	s ax - B i - L a1
advertències	n	ax d - b ax rr - t E1 n - s i - ax s
investigui	n	i m - b ax s - t i1 - G i
contraban	n	k O n - t r ax - B a1 n
ultres	n	u1 l - t r ax s
contínuament	n	k u n - t i - n u - ax - m e1 n
seny	n	s E1 J
dissoldre	n	d i - s O1 l - d r ax
damnificats	n	d ax m - n i - f i - k a1 t s
confiscar	n	k u m - f i s - k a1
entrevistat	n	ax n - t r ax - B i s - t a1 t
congelar	n	k u n - Z ax - l a1
monarquia	n	m u - n ax rr - k i1 - ax
dissolució	n	d i - s u - l u - s i - o1
manipular	n	m ax - n i - p u - l a1
guions	n	g i - o1 n s
emplaçar	n	ax m - p l ax - s a1
tir	n	t i1 rr
modernitzar	n	m u - D ax rr - n i d - z a1
assessorament	n	ax - s ax - s u - r ax - m e1 n
cos	n	k O1 s
improvisació	n	i m - p r u - B i - z ax - s i - o1
equatorians	n	ax - k w ax - t u - r i - a1 n s
abonament	n	ax - B u - n ax - m e1 n
anterioritat	n	ax n - t ax - r i - u - r i - t a1 t
pioner	n	p i - u - n e1
augura	n	ax uw - G u1 - r ax
enfortir	n	ax m - f u rr - t i1
petroler	n	p ax - t r u - l e1
plusvàlues	n	p l u z - B a1 - l u - ax s
tribut	n	t r i - B u1 t
lesionats	n	l ax - z i - u - n a1 t s
travessia	n	t r ax - B ax - s i1 - ax
aspiració	n	ax s - p i - r ax - s i - o1
electrònics	n	ax - l ax k - t r O1 - n i k s
desestimar	n	d ax - z ax s - t i - m a1
cartró	n	k ax rr - t r o1
perpetrat	n	p ax rr - p ax - t r a1 t
antelació	n	ax n - t ax - l ax - s i - o1
afganesa	n	ax v - G ax - n E1 - z ax
sostenible	n	s u s - t ax - n i1 b - b l ax
carències	n	k ax - r E1 n - s i - ax s
finalitzat	n	f i - n ax - l i d - z a1 t
distribuïdors	n	d i s - t r i - B u - i - D o1 s
saturació	n	s ax - t u - r ax - s i - o1
fèrria	n	f E1 - rr i - ax
escepticisme	n	ax - s ax p - t i - s i1 z - m ax
feixista	n	f ax - S i1 s - t ax
incomplir	n	i N - k u m - p l i1
amfitrió	n	ax m - f i - t r i - o1
docent	n	d u - s e1 n
multitudinària	n	m u l - t i - t u - D i - n a1 - r i - ax
animats	n	ax - n i - m a1 t s
importació	n	i m - p u rr - t ax - s i - o1
apartaments	n	ax - p ax rr - t ax - m e1 n s
cartellera	n	k ax rr - t ax - L e1 - r ax
legislativa	n	l ax - Z i z - l ax - t i1 - B ax
txetxena	n	tS ax t - S E1 - n ax
inverteix	n	i m - b ax rr - t E1 S
novament	n	n O - B ax - m e1 n
ascensor	n	ax - s ax n - s o1
papa	n	p a1 - p ax
flux	n	f l u1 k s
envair	n	ax m - b ax - i1
conspiració	n	k u n s - p i - r ax - s i - o1
televisor	n	t ax - l ax - B i - z o1
estrenada	n	ax s - t r ax - n a1 - D ax
grapat	n	g r ax - p a1 t
cancel·lar	n	k ax n - s ax - l a1
salons	n	s ax - l o1 n s
par	n	p a1 rr
idoni	n	i - D O1 - n i
energètic	n	ax - n ax rr - Z E1 - t i k
vigílies	n	b i - Z i1 - l i - ax s
veneçolà	n	b ax - n ax - s u - l a1
entregues	n	ax n - t r e1 - G ax s
traficants	n	t r ax - f i - k a1 n s
traïció	n	t r ax - i - s i - o1
premiats	n	p r ax - m i - a1 t s
recompensa	n	rr ax - k u m - p E1 n - s ax
desbloquejar	n	d ax z - B l u - k ax - Z a1
prejubilacions	n	p r e - Z u - B i - l ax - s i - o1 n s
planificar	n	p l ax - n i - f i - k a1
foment	n	f u - m e1 n
colombians	n	k u - l u m - b i - a1 n s
progressió	n	p r u - G r ax - s i - o1
suïssos	n	s u - i1 - s u s
ingredients	n	i N - g r ax - D i - e1 n s
reobertura	n	rr ax - u - B ax rr - t u1 - r ax
humorista	n	u - m u - r i1 s - t ax
gremi	n	g r E1 - m i
cotes	n	k O1 - t ax s
pretext	n	p r ax - t e1 k s t
ratificació	n	rr ax - t i - f i - k ax - s i - o1
premiar	n	p r ax - m i - a1
clientela	n	k l i - ax n - t E1 - l ax
desigual	n	d ax - z i - G w a1 l
vicepresidenta	n	b i - s ax - p r ax - z i - D e1 n - t ax
divertir	n	d i - B ax rr - t i1
homosexualitat	n	u - m u - s ax k - s u - ax - l i - t a1 t
favorablement	n	f ax - B u - r a b - b l ax - m e1 n
albergar	n	ax l - B ax r - G a1
animat	n	ax - n i - m a1 t
condicional	n	k u n - d i - s i - u - n a1 l
inviable	n	i m - b i - a1 b - b l ax
encertar	n	ax n - s ax rr - t a1
formigó	n	f u rr - m i - G o1
pessimisme	n	p ax - s i - m i1 z - m ax
puntuals	n	p u n - t u - a1 l s
protestants	n	p r u - t ax s - t a1 n s
amnistia	n	ax m - n i s - t i1 - ax
atrocitats	n	ax - t r u - s i - t a1 t s
ubicar	n	u - B i - k a1
algerians	n	ax l - Z ax - r i - a1 n s
elegància	n	ax - l ax - G a1 n - s i - ax
motoristes	n	m u - t u - r i1 s - t ax s
avalar	n	ax - B ax - l a1
rumor	n	rr u - m o1 rr
televisius	n	t ax - l ax - B i - z i1 uw s
bonança	n	b u - n a1 n - s ax
desaprofitar	n	d ax - z ax - p r u - f i - t a1
revaloritzar	n	rr ax - B ax - l u - r i d - z a1
recel	n	rr ax - s E1 l
ritual	n	rr i - t u - a1 l
sexualment	n	s ax k - s u - a l - m e1 n
nebot	n	n ax - B o1 t
aventurar	n	ax - B ax n - t u - r a1
mafiosos	n	m ax - f i - o1 - z u s
decebut	n	d ax - s ax - B u1 t
palestines	n	p ax - l ax s - t i1 - n ax s
farmàcia	n	f ax rr - m a1 - s i - ax
botí	n	b u - t i1
selectiu	n	s ax - l ax k - t i1 uw
pinsos	n	p i1 n - s u s
hostaleria	n	u s - t ax - l ax - r i1 - ax
digitals	n	d i - Z i - t a1 l s
pactada	n	p ax k - t a1 - D ax
multimèdia	n	m u l - t i - m E1 - D i - ax
antiavalots	n	a n - t i - ax - B ax - l O1 t s
donostiarra	n	d u - n u s - t i - a1 - rr ax
xenofòbia	n	S ax - n u - f O1 - B i - ax
cursar	n	k u rr - s a1
legítima	n	l ax - Z i1 - t i - m ax
ballarina	n	b ax - L ax - r i1 - n ax
ultradretà	n	u l - t r ax - D r ax - t a1
exdirigent	n	E g z - D i - r i - Z e1 n
guarderies	n	g w ax r - D ax - r i1 - ax s
munició	n	m u - n i - s i - o1
ensorrar	n	ax n - s u - rr a1
ingressats	n	i N - g r ax - s a1 t s
influent	n	i m - f l u - e1 n
mexicans	n	m ax k - s i - k a1 n s
assalariats	n	ax - s ax - l ax - r i - a1 t s
desembarcament	n	d ax - z ax m - b ax rr - k ax - m e1 n
soterrani	n	s u - t ax - rr a1 - n i
connecta	n	k u n - n e1 k - t ax
reactor	n	rr e - ax k - t o1
disbarat	n	d i z - B ax - r a1 t
processar	n	p r u - s ax - s a1
gestor	n	Z ax s - t o1
interceptar	n	i n - t ax rr - s ax p - t a1
reformista	n	rr ax - f u rr - m i1 s - t ax
paralitzat	n	p ax - r ax - l i d - z a1 t
punyalades	n	p u - J ax - l a1 - D ax s
tango	n	t a1 N - g u
reclam	n	rr ax - k l a1 m
recintes	n	rr ax - s i1 n - t ax s
semàfor	n	s ax - m a1 - f u rr
il·luminació	n	i - l u - m i - n ax - s i - o1
his	n	i1 s
indirectament	n	i n - d i - r E k - t ax - m e1 n
carboni	n	k ax r - B O1 - n i
distribuïdores	n	d i s - t r i - B u - i - D o1 - r ax s
intriga	n	i n - t r i1 - G ax
pú	n	p u1
filòsof	n	f i - l O1 - z u f
descontentament	n	d ax s - k u n - t ax n - t ax - m e1 n
edificació	n	ax - D i - f i - k ax - s i - o1
noruec	n	n u - r u - E1 k
africana	n	ax - f r i - k a1 - n ax
audiències	n	ax uw - D i - E1 n - s i - ax s
consol	n	k u n - s O1 l
capturat	n	k ax p - t u - r a1 t
sensiblement	n	s ax n - s i b - b l ax - m e1 n
patrulles	n	p ax - t r u1 - L ax s
equiparar	n	ax - k i - p ax - r a1
acreditar	n	ax - k r ax - D i - t a1
oculta	n	u - k u1 l - t ax
sucursal	n	s u - k u rr - s a1 l
interrogat	n	i n - t ax - rr u - G a1 t
formalitzar	n	f u rr - m ax - l i d - z a1
urbanístiques	n	u r - B ax - n i1 s - t i - k ax s
ocasionar	n	u - k ax - z i - u - n a1
pressionat	n	p r ax - s i - u - n a1 t
solistes	n	s u - l i1 s - t ax s
recels	n	rr ax - s E1 l s
barats	n	b ax - r a1 t s
acomiada	n	ax - k u - m i - a1 - D ax
porc	n	p O1 rr k
programar	n	p r u - G r ax - m a1
emplaçament	n	ax m - p l ax - s ax - m e1 n
rebots	n	rr ax - B o1 t s
aftosa	n	ax f - t o1 - z ax
còctel	n	k O1 k - t ax l
venedor	n	b ax - n ax - D o1
armades	n	ax rr - m a1 - D ax s
bàndols	n	b a1 n - d u l s
centrista	n	s ax n - t r i1 s - t ax
disponibilitat	n	d i s - p u - n i - B i - l i - t a1 t
aerolínia	n	ax - e - r u - l i1 - n i - ax
reiteradament	n	rr ax - i - t ax - r a - D ax - m e1 n
enlairar	n	ax n - l ax j - r a1
destrossat	n	d ax s - t r u - s a1 t
governabilitat	n	g u - B ax rr - n ax - B i - l i - t a1 t
flexible	n	f l ax k - s i1 b - b l ax
antimundialització	n	a n - t i - m u n - d i - ax - l i d - z ax - s i - o1
quilo	n	k i1 - l u
ubicada	n	u - B i - k a1 - D ax
consultora	n	k u n - s u l - t o1 - r ax
embrió	n	ax m - b r i - o1
fantasia	n	f ax n - t ax - z i1 - ax
partidista	n	p ax rr - t i - D i1 s - t ax
paperetes	n	p ax - p ax - r E1 - t ax s
llicenciat	n	L i - s ax n - s i - a1 t
llaços	n	L a1 - s u s
farmàcies	n	f ax rr - m a1 - s i - ax s
danès	n	d ax - n E1 s
purament	n	p u - r ax - m e1 n
envelliment	n	ax m - b ax - L i - m e1 n
ingressada	n	i N - g r ax - s a1 - D ax
urbanístics	n	u r - B ax - n i1 s - t i k s
aparcat	n	ax - p ax rr - k a1 t
transcendir	n	t r ax - s ax n - d i1
vicepresidència	n	b i - s ax - p r ax - z i - D E1 n - s i - ax
emocionat	n	ax - m u - s i - u - n a1 t
sobiranista	n	s u - B i - r ax - n i1 s - t ax
beneficiaris	n	b ax - n ax - f i - s i - a1 - r i s
còmplices	n	k O1 m - p l i - s ax s
recrea	n	rr ax - k r e1 - ax
guapa	n	g w a1 - p ax
conviuen	n	k u m - b i1 - w ax n
irònic	n	i - r O1 - n i k
al·lega	n	ax - l e1 - G ax
corrida	n	k u - rr i1 - D ax
claustre	n	k l a1 uw s - t r ax
ressalta	n	rr ax - s a1 l - t ax
donants	n	d u - n a1 n s
maternitat	n	m ax - t ax rr - n i - t a1 t
convoca	n	k u m - b o1 - k ax
tàndem	n	t a1 n - d ax m
higiene	n	i - Z i - E1 - n ax
fusionar	n	f u - z i - u - n a1
clandestina	n	k l ax n - d ax s - t i1 - n ax
metàfora	n	m ax - t a1 - f u - r ax
favorita	n	f ax - B u - r i1 - t ax
estómac	n	ax s - t o1 - m ax k
prossegueix	n	p r u - s ax - G E1 S
instrumental	n	i n s - t r u - m ax n - t a1 l
debutant	n	d ax - B u - t a1 n
pinya	n	p i1 - J ax
patrocinadors	n	p ax - t r u - s i - n ax - D o1 s
aliada	n	ax - l i - a1 - D ax
gitana	n	Z i - t a1 - n ax
compravenda	n	k o m - p r ax - B E1 n - d ax
emblemàtic	n	ax m - b l ax - m a1 - t i k
ratifica	n	rr ax - t i - f i1 - k ax
ardent	n	ax r - D e1 n
previsiblement	n	p r ax - B i - z i b - b l ax - m e1 n
jaqueta	n	Z ax - k E1 - t ax
detallar	n	d ax - t ax - L a1
cineastes	n	s i - n e - a1 s - t ax s
emergències	n	ax - m ax rr - Z E1 n - s i - ax s
ovació	n	u - B ax - s i - o1
presumir	n	p r ax - z u - m i1
qüestionat	n	k w ax s - t i - u - n a1 t
semàfors	n	s ax - m a1 - f u rr s
competeixen	n	k u m - p ax - t E1 - S ax n
nòmic	n	n O1 - m i k
insultar	n	i n - s u l - t a1
difunt	n	d i - f u1 n
recriminar	n	rr ax - k r i - m i - n a1
irrupció	n	i - rr u p - s i - o1
baixista	n	b ax - S i1 s - t ax
comptabilitzar	n	k u m - t ax - B i - l i d - z a1
dimitit	n	d i - m i - t i1 t
expectativa	n	ax k s - p ax k - t ax - t i1 - B ax
finalistes	n	f i - n ax - l i1 s - t ax s
transcendit	n	t r ax - s ax n - d i1 t
automàtic	n	ax uw - t u - m a1 - t i k
disputen	n	d i s - p u1 - t ax n
desocupats	n	d ax - z u - k u - p a1 t s
disputaran	n	d i s - p u - t ax - r a1 n
prestigiosa	n	p r ax s - t i - Z i - o1 - z ax
residuals	n	rr ax - z i - D u - a1 l s
dissenyada	n	d i - s ax - J a1 - D ax
croada	n	k r u - a1 - D ax
solvència	n	s u l - B E1 n - s i - ax
presidirà	n	p r ax - z i - D i - r a1
ultimàtum	n	u l - t i - m a1 - t u m
àlies	n	a1 - l i - ax s
atropellar	n	ax - t r u - p ax - L a1
incomprensible	n	i N - k u m - p r ax n - s i1 b - b l ax
socialment	n	s u - s i - a l - m e1 n
pessimista	n	p ax - s i - m i1 s - t ax
protesten	n	p r u - t e1 s - t ax n
concessionàries	n	k u n - s ax - s i - u - n a1 - r i - ax s
comitiva	n	k u - m i - t i1 - B ax
tennistes	n	t ax n - n i1 s - t ax s
implacable	n	i m - p l ax - k a1 b - b l ax
brillantor	n	b r i - L ax n - t o1
pionera	n	p i - u - n e1 - r ax
àlbum	n	a1 l - B u m
exlíder	n	E g z - l i1 - D ax
brindar	n	b r i n - d a1
bressol	n	b r ax - s O1 l
missiva	n	m i - s i1 - B ax
alegre	n	ax - l e1 - G r ax
automàtica	n	ax uw - t u - m a1 - t i - k ax
inèdites	n	i - n E1 - D i - t ax s
inèdita	n	i - n E1 - D i - t ax
convocades	n	k u m - b u - k a1 - D ax s
precaucions	n	p r ax - k ax uw - s i - o1 n s
abocaments	n	ax - B u - k ax - m e1 n s
matances	n	m ax - t a1 n - s ax s
humilitat	n	u - m i - l i - t a1 t
atracament	n	ax - t r ax - k ax - m e1 n
hectòmetres	n	ax k - t O1 - m ax - t r ax s
estàtua	n	ax s - t a1 - t u - ax
feixistes	n	f ax - S i1 s - t ax s
ganxo	n	g a1 n - S u
entregats	n	e n - t r ax - G a1 t s
tàctic	n	t a1 k - t i k
salvament	n	s ax l - B ax - m e1 n
supervisió	n	s u - p ax r - B i - z i - o1
portuguesos	n	p u rr - t u - G E1 - z u s
erigir	n	ax - r i - Z i1
xalet	n	S ax - l E1 t
arrestar	n	ax - rr ax s - t a1
monitors	n	m u - n i - t o1 s
absolució	n	ax p - s u - l u - s i - o1
privatitzacions	n	p r i - B ax - t i d - z ax - s i - o1 n s
veïnat	n	b ax - i - n a1 t
automoció	n	a uw - t u - m u - s i - o1
estrès	n	ax s - t r E1 s
destapar	n	d ax s - t ax - p a1
repatriació	n	rr ax - p ax - t r i - ax - s i - o1
irresponsable	n	i - rr ax s - p u n - s a1 b - b l ax
finançat	n	f i - n ax n - s a1 t
quirúrgica	n	k i - r u1 rr - Z i - k ax
fredor	n	f r ax - D o1
repàs	n	rr ax - p a1 s
esquiadors	n	ax s - k i - ax - D o1 s
asiàtics	n	ax - z i - a1 - t i k s
llistó	n	L i s - t o1
plantilles	n	p l ax n - t i1 - L ax s
puntual	n	p u n - t u - a1 l
creatiu	n	k r e - ax - t i1 uw
interí	n	i n - t ax - r i1
avala	n	ax - B a1 - l ax
organigrama	n	u r - G ax - n i - G r a1 - m ax
puntades	n	p u n - t a1 - D ax s
cònsol	n	k O1 n - s u l
estancament	n	ax s - t ax N - k ax - m e1 n
allotjar	n	ax - L u d - Z a1
carteres	n	k ax rr - t e1 - r ax s
hoteler	n	u - t ax - l e1
feixisme	n	f ax - S i1 z - m ax
pimes	n	p i1 - m ax s
voleibol	n	b O - l ax j - B O1 l
colar	n	k u - l a1
alumnat	n	ax - l u m - n a1 t
retribució	n	rr ax - t r i - B u - s i - o1
suplent	n	s u - p l e1 n
infantesa	n	i m - f ax n - t E1 - z ax
predisposició	n	p r ax - D i s - p u - z i - s i - o1
impulsor	n	i m - p u l - s o1
alcaldable	n	ax l - k ax l - d a1 b - b l ax
boicotejar	n	b u j - k u - t ax - Z a1
conflictius	n	k u m - f l i k - t i1 uw s
demandants	n	d ax - m ax n - d a1 n s
madrilenys	n	m ax - D r i - l E1 J s
sueño	n	s u - E1 - J u
desproporcionada	n	d ax s - p r u - p u rr - s i - u - n a1 - D ax
dálmatas	n	d a1 l - m ax - t ax s
locos	n	l O1 - k u s
llegendari	n	L ax - Z ax n - d a1 - r i
declinar	n	d ax - k l i - n a1
pierde	n	p i - E1 r - D ax
commemoració	n	k u m - m ax - m u - r ax - s i - o1
consentiment	n	k u n - s ax n - t i - m e1 n
evidenciar	n	ax - B i - D ax n - s i - a1
propiciat	n	p r u - p i - s i - a1 t
gradual	n	g r ax - D u - a1 l
col·lapsar	n	k u - l ax p - s a1
innovadora	n	i n - n u - B ax - D o1 - r ax
habilitar	n	ax - B i - l i - t a1
mandats	n	m ax n - d a1 t s
reactivar	n	rr e - ax k - t i - B a1
metropolità	n	m ax - t r u - p u - l i - t a1
prosperitat	n	p r u s - p ax - r i - t a1 t
periòdicament	n	p ax - r i - O - D i - k ax - m e1 n
repulsa	n	rr ax - p u1 l - s ax
guardaespatlles	n	g w a r - D ax s - p a1 L - L ax s
endurir	n	ax n - d u - r i1
peruans	n	p ax - r u - a1 n s
contaminants	n	k u n - t ax - m i - n a1 n s
gai	n	g a1 j
terribles	n	t ax - rr i1 b - b l ax s
paralització	n	p ax - r ax - l i d - z ax - s i - o1
pluralisme	n	p l u - r ax - l i1 z - m ax
segment	n	s ax g - m e1 n
lentament	n	l e n - t ax - m e1 n
nevades	n	n ax - B a1 - D ax s
retribucions	n	rr ax - t r i - B u - s i - o1 n s
sisme	n	s i1 z - m ax
marea	n	m ax - r e1 - ax
controvertit	n	k u n - t r u - B ax rr - t i1 t
malagueny	n	m ax - l ax - G E1 J
migcamp	n	m i tS - k a1 m
impartir	n	i m - p ax rr - t i1
congressistes	n	k u N - g r ax - s i1 s - t ax s
consensuat	n	k u n - s ax n - s u - a1 t
borsaris	n	b u rr - s a1 - r i s
mama	n	m a1 - m ax
imputació	n	i m - p u - t ax - s i - o1
temporalitat	n	t ax m - p u - r ax - l i - t a1 t
teles	n	t E1 - l ax s
vetar	n	b ax - t a1
idil·li	n	i - D i1 - l i
radica	n	rr ax - D i1 - k ax
pre	n	p r e1
gais	n	g a1 j s
desgraciadament	n	d ax z - G r ax - s i - a - D ax - m e1 n
recitals	n	rr ax - s i - t a1 l s
novel	n	n u - B E1 l
supervivent	n	s u - p ax r - B i - B e1 n
competent	n	k u m - p ax - t e1 n
desconeixement	n	d ax s - k u - n ax - S ax - m e1 n
alabar	n	ax - l ax - B a1
insostenible	n	i n - s u s - t ax - n i1 b - b l ax
polonès	n	p u - l u - n E1 s
sufragar	n	s u - f r ax - G a1
congelació	n	k u n - Z ax - l ax - s i - o1
laboristes	n	l ax - B u - r i1 s - t ax s
noble	n	n o1 b - b l ax
convencionals	n	k u m - b ax n - s i - u - n a1 l s
medecines	n	m ax - D ax - s i1 - n ax s
immobiliàries	n	i m - m u - B i - l i - a1 - r i - ax s
sanejament	n	s ax - n ax - Z ax - m e1 n
detecció	n	d ax - t ax k - s i - o1
dinamisme	n	d i - n ax - m i1 z - m ax
mili	n	m i1 - l i
cota	n	k O1 - t ax
fallat	n	f ax - L a1 t
empleada	n	ax m - p l e - a1 - D ax
rebaixat	n	rr ax - B ax - S a1 t
devaluació	n	d ax - B ax - l u - ax - s i - o1
butà	n	b u - t a1
discogràfic	n	d i s - k u - G r a1 - f i k
bacteri	n	b ax k - t E1 - r i
incursió	n	i N - k u rr - s i - o1
impensable	n	i m - p ax n - s a1 b - b l ax
entranyable	n	ax n - t r ax - J a1 b - b l ax
mànager	n	m a1 - n ax - Z ax rr
zel	n	z E1 l
greuge	n	g r e1 uw - Z ax
autocrítica	n	a uw - t u - k r i1 - t i - k ax
assistent	n	ax - s i s - t e1 n
sinistrat	n	s i - n i s - t r a1 t
seleccionar	n	s ax - l ax k - s i - u - n a1
democratització	n	d ax - m u - k r ax - t i d - z ax - s i - o1
pèrits	n	p E1 - r i t s
esplendor	n	ax s - p l ax n - d o1
vitalici	n	b i - t ax - l i1 - s i
acomiadat	n	ax - k u - m i - ax - D a1 t
meravellós	n	m ax - r ax - B ax - L o1 s
austríacs	n	ax uw s - t r i1 - ax k s
trasplantament	n	t r ax s - p l ax n - t ax - m e1 n
avioneta	n	ax - B i - u - n E1 - t ax
esclaus	n	ax s - k l a1 uw s
plaga	n	p l a1 - G ax
adequar	n	ax - D ax - k w a1
colons	n	k u - l o1 n s
enveja	n	ax m - b E1 - Z ax
exdiputat	n	E g z - D i - p u - t a1 t
desbordar	n	d ax z - B u r - D a1
subministrar	n	s u b - m i - n i s - t r a1
sergent	n	s ax rr - Z e1 n
míssil	n	m i1 - s i l
candidates	n	k ax n - d i - D a1 - t ax s
paisà	n	p ax j - z a1
agraïment	n	ax - G r ax - i - m e1 n
enclavament	n	ax N - k l ax - B ax - m e1 n
encarnar	n	ax N - k ax rr - n a1
hipoteca	n	i - p u - t E1 - k ax
convocants	n	k u m - b u - k a1 n s
ordenança	n	u r - D ax - n a1 n - s ax
discogràfiques	n	d i s - k u - G r a1 - f i - k ax s
adeptes	n	ax - D e1 p - t ax s
colofó	n	k u - l u - f o1
editora	n	ax - D i - t o1 - r ax
llatinoamericans	n	L ax - t i - n u - ax - m ax - r i - k a1 n s
indocumentats	n	i n - d u - k u - m ax n - t a1 t s
engany	n	ax N - g a1 J
brutícia	n	b r u - t i1 - s i - ax
espiral	n	ax s - p i - r a1 l
inèdit	n	i - n E1 - D i t
factible	n	f ax k - t i1 b - b l ax
integrista	n	i n - t ax - G r i1 s - t ax
rematada	n	rr ax - m ax - t a1 - D ax
xerrada	n	S ax - rr a1 - D ax
genial	n	Z ax - n i - a1 l
reelegit	n	rr e - ax - l ax - Z i1 t
adjudicat	n	ax d - Z u - D i - k a1 t
aplaudiment	n	ax - p l ax uw - D i - m e1 n
paradoxalment	n	p ax - r ax - D u k - s a l - m e1 n
ignorància	n	i g - n u - r a1 n - s i - ax
accidental	n	ax k - s i - D ax n - t a1 l
probabilitat	n	p r u - B ax - B i - l i - t a1 t
encanta	n	ax N - k a1 n - t ax
lligueta	n	L i - G E1 - t ax
triomfal	n	t r i - u m - f a1 l
piscines	n	p i - s i1 - n ax s
calvari	n	k ax l - B a1 - r i
ajusta	n	ax - Z u1 s - t ax
màgic	n	m a1 - Z i k
libanès	n	l i - B ax - n E1 s
melodies	n	m ax - l u - D i1 - ax s
dràstica	n	d r a1 s - t i - k ax
infinitat	n	i m - f i - n i - t a1 t
provisionalment	n	p r u - B i - z i - u - n a l - m e1 n
retrata	n	rr ax - t r a1 - t ax
essencialment	n	ax - s ax n - s i - a l - m e1 n
còmplice	n	k O1 m - p l i - s ax
grandesa	n	g r ax n - d E1 - z ax
negativament	n	n ax - G ax - t i - B ax - m e1 n
minisèrie	n	m i - n i - s E1 - r i - ax
generacional	n	Z ax - n ax - r ax - s i - u - n a1 l
carisma	n	k ax - r i1 z - m ax
po	n	p o1
llançaments	n	L ax n - s ax - m e1 n s
marroquines	n	m ax - rr u - k i1 - n ax s
negocien	n	n ax - G u - s i1 - ax n
campaments	n	k ax m - p ax - m e1 n s
got	n	g O1 t
licitació	n	l i - s i - t ax - s i - o1
dioxines	n	d i - u k - s i1 - n ax s
le	n	l e1
ocupacional	n	u - k u - p ax - s i - u - n a1 l
precària	n	p r ax - k a1 - r i - ax
ferotge	n	f ax - r O1 d - Z ax
andaluses	n	ax n - d ax - l u1 - z ax s
detalla	n	d ax - t a1 - L ax
milionaris	n	m i - l i - u - n a1 - r i s
crueltat	n	k r u - ax l - t a1 t
prosperar	n	p r u s - p ax - r a1
nazisme	n	n ax - z i1 z - m ax
estrenes	n	ax s - t r E1 - n ax s
centredreta	n	s e n - t r ax - D r E1 - t ax
imputar	n	i m - p u - t a1
detractors	n	d ax - t r ax k - t o1 s
espot	n	ax s - p O1 t
distanciar	n	d i s - t ax n - s i - a1
bicicletes	n	b i - s i - k l E1 - t ax s
mediambientals	n	m ax - D i - ax m - b i - ax n - t a1 l s
inadmissible	n	i - n ax d - m i - s i1 b - b l ax
deportats	n	d ax - p u rr - t a1 t s
activament	n	ax k - t i - B ax - m e1 n
reputació	n	rr ax - p u - t ax - s i - o1
ries	n	rr i1 - ax s
lavabo	n	l ax - B a1 - B u
intermediaris	n	i n - t ax rr - m ax - D i - a1 - r i s
sub	n	s u p
emperador	n	ax m - p ax - r ax - D o1
realitzadors	n	rr e - ax - l i d - z ax - D o1 s
competeix	n	k u m - p ax - t E1 S
resignació	n	rr ax - z i g - n ax - s i - o1
rebot	n	rr ax - B o1 t
anècdotes	n	ax - n E1 g - d u - t ax s
revenja	n	rr ax - B e1 n - Z ax
intimidació	n	i n - t i - m i - D ax - s i - o1
horrible	n	u - rr i1 b - b l ax
motorista	n	m u - t u - r i1 s - t ax
farmacèutic	n	f ax rr - m ax - s E1 uw - t i k
proveir	n	p r u - B ax - i1
declivi	n	d ax - k l i1 - B i
considerablement	n	k u n - s i - D ax - r a b - b l ax - m e1 n
activista	n	ax k - t i - B i1 s - t ax
dissenys	n	d i - s E1 J s
eurodiputats	n	E uw - r u - D i - p u - t a1 t s
lleidatà	n	L ax j - D ax - t a1
tanatori	n	t ax - n ax - t O1 - r i
racial	n	rr ax - s i - a1 l
llibreries	n	L i - B r ax - r i1 - ax s
visiblement	n	b i - z i b - b l ax - m e1 n
hospitalitzat	n	u s - p i - t ax - l i d - z a1 t
humiliació	n	u - m i - l i - ax - s i - o1
comercialitzar	n	k u - m ax rr - s i - ax - l i d - z a1
irresponsabilitat	n	i - rr ax s - p u n - s ax - B i - l i - t a1 t
improbable	n	i m - p r u - B a1 b - b l ax
circuits	n	s i rr - k u1 j t s
investiguen	n	i m - b ax s - t i1 - G ax n
paternitat	n	p ax - t ax rr - n i - t a1 t
sindicalistes	n	s i n - d i - k ax - l i1 s - t ax s
materialitzar	n	m ax - t ax - r i - ax - l i d - z a1
convent	n	k u m - b e1 n
extracció	n	ax k s - t r ax k - s i - o1
rehabilitar	n	rr e - ax - B i - l i - t a1
repassar	n	rr ax - p ax - s a1
automobilístic	n	a uw - t u - m u - B i - l i1 s - t i k
violinista	n	b i - u - l i - n i1 s - t ax
remolc	n	rr ax - m o1 l k
interposar	n	i n - t ax rr - p u - z a1
històricament	n	i s - t O - r i - k ax - m e1 n
certificats	n	s ax rr - t i - f i - k a1 t s
arrabassar	n	ax - rr ax - B ax - s a1
incentivar	n	i n - s ax n - t i - B a1
atropellat	n	ax - t r u - p ax - L a1 t
beisbol	n	b ax j z - B O1 l
mag	n	m a1 k
filtració	n	f i l - t r ax - s i - o1
potable	n	p u - t a1 b - b l ax
incòmode	n	i N - k O1 - m u - D ax
francament	n	f r a N - k ax - m e1 n
esgrimir	n	ax z - G r i - m i1
suprem	n	s u - p r e1 m
empobrit	n	ax m - p u - B r i1 t
convincent	n	k u m - b i n - s e1 n
complica	n	k u m - p l i1 - k ax
transgènics	n	t r ax n - Z E1 - n i k s
patriotisme	n	p ax - t r i - u - t i1 z - m ax
dispara	n	d i s - p a1 - r ax
rotonda	n	rr u - t o1 n - d ax
diagnosticar	n	d i - ax g - n u s - t i - k a1
seleccionats	n	s ax - l ax k - s i - u - n a1 t s
convocarà	n	k u m - b u - k ax - r a1
supervisar	n	s u - p ax r - B i - z a1
competidor	n	k u m - p ax - t i - D o1
antibiòtics	n	a n - t i - B i - O1 - t i k s
distribuïdora	n	d i s - t r i - B u - i - D o1 - r ax
llueix	n	L u - E1 S
brasilers	n	b r ax - z i - l e1 s
matinal	n	m ax - t i - n a1 l
espanyolista	n	ax s - p ax - J u - l i1 s - t ax
labor	n	l ax - B o1 rr
eslògan	n	ax z - l O1 - G ax n
desembocadura	n	d ax - z ax m - b u - k ax - D u1 - r ax
convidada	n	k u m - b i - D a1 - D ax
perfila	n	p ax rr - f i1 - l ax
inconstitucionalitat	n	i N - k u n s - t i - t u - s i - u - n ax - l i - t a1 t
congregar	n	k u N - g r ax - G a1
videojocs	n	b i - D ax - u - Z O1 k s
rectificació	n	rr ax k - t i - f i - k ax - s i - o1
religions	n	rr ax - l i - Z i - o1 n s
sonores	n	s u - n o1 - r ax s
eficiència	n	ax - f i - s i - E1 n - s i - ax
fallada	n	f ax - L a1 - D ax
enginy	n	ax n - Z i1 J
encadenar	n	ax N - k ax - D ax - n a1
encapçalats	n	ax N - k ax p - s ax - l a1 t s
divergències	n	d i - B ax rr - Z E1 n - s i - ax s
reaparèixer	n	rr e - ax - p ax - r E1 - S ax
retrobament	n	rr ax - t r u - B ax - m e1 n
filtracions	n	f i l - t r ax - s i - o1 n s
subdelegat	n	s u b - d ax - l ax - G a1 t
vulnera	n	b u l - n e1 - r ax
gestionat	n	Z ax s - t i - u - n a1 t
exgovernador	n	E g z - G u - B ax rr - n ax - D o1
viola	n	b i - O1 - l ax
reporter	n	rr ax - p u rr - t e1
insuportable	n	i n - s u - p u rr - t a1 b - b l ax
capitans	n	k ax - p i - t a1 n s
escènic	n	ax - s E1 - n i k
tendresa	n	t ax n - d r E1 - z ax
vincle	n	b i1 N - k l ax
capgirar	n	k a b - Z i - r a1
rodalies	n	rr u - D ax - l i1 - ax s
equiparació	n	ax - k i - p ax - r ax - s i - o1
madridistes	n	m ax - D r i - D i1 s - t ax s
vestidors	n	b ax s - t i - D o1 s
futur	n	f u - t u1 rr
cooperatives	n	k u - u - p ax - r ax - t i1 - B ax s
desagradable	n	d ax - z ax - G r ax - D a1 b - b l ax
publicitaris	n	p u - B l i - s i - t a1 - r i s
navegar	n	n ax - B ax - G a1
modista	n	m u - D i1 s - t ax
còmics	n	k O1 - m i k s
preacord	n	p r e - ax - k O1 rr t
partitura	n	p ax rr - t i - t u1 - r ax
impactar	n	i m - p ax k - t a1
casernes	n	k ax - z E1 rr - n ax s
mòduls	n	m O1 - D u l s
ajustat	n	ax - Z u s - t a1 t
aula	n	a1 uw - l ax
davantera	n	d ax - B ax n - t e1 - r ax
coreògraf	n	k u - r ax - O1 - G r ax f
suspesa	n	s u s - p E1 - z ax
txec	n	tS E1 k
techno	n	t e1 g - n u
xiulets	n	S i uw - l E1 t s
equilibrar	n	ax - k i - l i - B r a1
quests	n	k e1 s t s
hipermercats	n	i - p ax rr - m ax rr - k a1 t s
retreure	n	rr ax - t r E1 uw - r ax
intolerància	n	i n - t u - l ax - r a1 n - s i - ax
santuari	n	s ax n - t u - a1 - r i
telefonar	n	t ax - l ax - f u - n a1
informadors	n	i m - f u rr - m ax - D o1 s
apropiar	n	ax - p r u - p i - a1
recrear	n	rr ax - k r e - a1
conflictiva	n	k u m - f l i k - t i1 - B ax
embuts	n	ax m - b u1 t s
automàticament	n	ax uw - t u - m a - t i - k ax - m e1 n
federalisme	n	f ax - D ax - r ax - l i1 z - m ax
litigi	n	l i - t i1 - Z i
substancialment	n	s u p s - t ax n - s i - a l - m e1 n
anticipada	n	ax n - t i - s i - p a1 - D ax
interrupció	n	i n - t ax - rr u p - s i - o1
meteorològiques	n	m ax - t ax - u - r u - l O1 - Z i - k ax s
deslleial	n	d ax z - L ax - y a1 l
entrena	n	ax n - t r E1 - n ax
simpàtic	n	s i m - p a1 - t i k
constructors	n	k u n s - t r u k - t o1 s
beneficiarà	n	b ax - n ax - f i - s i - ax - r a1
sucursals	n	s u - k u rr - s a1 l s
miners	n	m i - n e1 s
reticent	n	rr ax - t i - s e1 n
quiròfan	n	k i - r O1 - f ax n
creativa	n	k r e - ax - t i1 - B ax
navarrès	n	n ax - B ax - rr E1 s
batxillerat	n	b ax t - S i - L ax - r a1 t
negociadora	n	n ax - G u - s i - ax - D o1 - r ax
cotitzen	n	k u - t i1 d - z ax n
visat	n	b i - z a1 t
verdaders	n	b ax r - D ax - D e1 s
poliesportiu	n	p O - l i - ax s - p u rr - t i1 uw
perifèria	n	p ax - r i - f E1 - r i - ax
okupa	n	u - k u1 - p ax
guardonat	n	g w ax r - D u - n a1 t
subsòl	n	s u p - s O1 l
saviesa	n	s ax - B i - E1 - z ax
apassionant	n	ax - p ax - s i - u - n a1 n
llistat	n	L i s - t a1 t
preferent	n	p r ax - f ax - r e1 n
intermediari	n	i n - t ax rr - m ax - D i - a1 - r i
captació	n	k ax p - t ax - s i - o1
muscular	n	m u s - k u - l a1 rr
matriculació	n	m ax - t r i - k u - l ax - s i - o1
rerefons	n	rr e - r ax - f o1 n s
monges	n	m O1 n - Z ax s
tanda	n	t a1 n - d ax
tàctiques	n	t a1 k - t i - k ax s
requalificació	n	rr ax - k w ax - l i - f i - k ax - s i - o1
patrimonial	n	p ax - t r i - m u - n i - a1 l
veterana	n	b ax - t ax - r a1 - n ax
perpetrar	n	p ax rr - p ax - t r a1
banyistes	n	b ax - J i1 s - t ax s
micròfons	n	m i - k r O1 - f u n s
senzillesa	n	s ax n - z i - L E1 - z ax
aeròdrom	n	ax - e - r O1 - D r u m
vulnerar	n	b u l - n ax - r a1
disputes	n	d i s - p u1 - t ax s
exportar	n	ax k s - p u rr - t a1
atracadors	n	ax - t r ax - k ax - D o1 s
guerriller	n	g ax - rr i - L e1
jaciment	n	Z ax - s i - m e1 n
regants	n	rr ax - G a1 n s
automàtics	n	ax uw - t u - m a1 - t i k s
emotiu	n	ax - m u - t i1 uw
explorar	n	ax k s - p l u - r a1
distintiu	n	d i s - t i n - t i1 uw
aragonesa	n	ax - r ax - G u - n E1 - z ax
encapçalen	n	ax N - k ax p - s a1 - l ax n
subcomissió	n	s u p - k u - m i - s i - o1
ortodoxa	n	u rr - t u - D o1 k - s ax
presentadors	n	p r ax - z ax n - t ax - D o1 s
sistemàticament	n	s i s - t ax - m a - t i - k ax - m e1 n
corrides	n	k u - rr i1 - D ax s
tumor	n	t u - m o1 rr
admissió	n	ax d - m i - s i - o1
dominical	n	d u - m i - n i - k a1 l
constructores	n	k u n s - t r u k - t o1 - r ax s
fragilitat	n	f r ax - Z i - l i - t a1 t
forense	n	f u - r E1 n - s ax
imprevisible	n	i m - p r ax - B i - z i1 b - b l ax
alentiment	n	ax - l ax n - t i - m e1 n
córner	n	k o1 rr - n ax
descentralització	n	d ax - s ax n - t r ax - l i d - z ax - s i - o1
desvincular	n	d ax z - B i N - k u - l a1
commoció	n	k u m - m u - s i - o1
rutina	n	rr u - t i1 - n ax
coreografies	n	k u - r ax - u - G r ax - f i1 - ax s
hipotecaris	n	i - p u - t ax - k a1 - r i s
sonda	n	s o1 n - d ax
frontalment	n	f r u n - t a l - m e1 n
suavitzar	n	s u - ax - B i d - z a1
recanvi	n	rr ax - k a1 m - b i
macedoni	n	m ax - s ax - D O1 - n i
sobrenom	n	s o - B r ax - n O1 m
dolorosa	n	d u - l u - r o1 - z ax
capturats	n	k ax p - t u - r a1 t s
insult	n	i n - s u1 l
discrepància	n	d i s - k r ax - p a1 n - s i - ax
electes	n	ax - l E1 k - t ax s
sol·licitada	n	s u - l i - s i - t a1 - D ax
itineraris	n	i - t i - n ax - r a1 - r i s
infectats	n	i m - f ax k - t a1 t s
contenidor	n	k u n - t ax - n i - D o1
subsecretari	n	s u p - s ax - k r ax - t a1 - r i
lenni	n	l E1 n - n i
edita	n	ax - D i1 - t ax
accionariat	n	ax k - s i - u - n ax - r i - a1 t
utopia	n	u - t u - p i1 - ax
reticents	n	rr ax - t i - s e1 n s
prò	n	p r O1
elèctrics	n	ax - l E1 k - t r i k s
gitano	n	Z i - t a1 - n u
imputen	n	i m - p u1 - t ax n
tremenda	n	t r ax - m e1 n - d ax
remodelació	n	rr ax - m u - D ax - l ax - s i - o1
enganxar	n	ax N - g ax n - S a1
detonant	n	d ax - t u - n a1 n
rivalitat	n	rr i - B ax - l i - t a1 t
arxivar	n	ax rr - S i - B a1
bloquejat	n	b l u - k ax - Z a1 t
ratificada	n	rr ax - t i - f i - k a1 - D ax
porcina	n	p u rr - s i1 - n ax
demolició	n	d ax - m u - l i - s i - o1
ultradreta	n	u l - t r ax - D r E1 - t ax
desbancar	n	d ax z - B ax N - k a1
deixalles	n	d ax - S a1 - L ax s
visibilitat	n	b i - z i - B i - l i - t a1 t
expositors	n	ax k s - p u - z i - t o1 s
alleujar	n	ax - L ax uw - Z a1
inserció	n	i n - s ax rr - s i - o1
reprimir	n	rr ax - p r i - m i1
expropiació	n	ax k s - p r u - p i - ax - s i - o1
fitxes	n	f i1 t - S ax s
ley	n	l E1 j
rotunda	n	rr u - t u1 n - d ax
esplèndid	n	ax s - p l E1 n - d i t
pólvora	n	p o1 l - B u - r ax
hidrocarburs	n	i - D r u - k ax r - B u1 rr s
fart	n	f a1 rr t
sana	n	s a1 - n ax
salsa	n	s a1 l - s ax
sevillana	n	s ax - B i - L a1 - n ax
urbanitzacions	n	u r - B ax - n i d - z ax - s i - o1 n s
celeritat	n	s ax - l ax - r i - t a1 t
rescatat	n	rr ax s - k ax - t a1 t
desafiar	n	d ax - z ax - f i - a1
mesquites	n	m ax s - k i1 - t ax s
desobediència	n	d ax - z u - B ax - D i - E1 n - s i - ax
cerimònies	n	s ax - r i - m O1 - n i - ax s
fiable	n	f i - a1 b - b l ax
fortament	n	f O rr - t ax - m e1 n
esprint	n	ax s - p r i1 n
secreto	n	s ax - k r e1 - t u
traspassos	n	t r ax s - p a1 - s u s
passaports	n	p a - s ax - p O1 rr s
emigrar	n	ax - m i - G r a1
joieria	n	Z u - y ax - r i1 - ax
hemicicle	n	ax - m i - s i1 - k l ax
replantejar	n	rr ax - p l ax n - t ax - Z a1
filmar	n	f i l - m a1
administradors	n	ax d - m i - n i s - t r ax - D o1 s
cirurgià	n	s i - r u rr - Z i - a1
accionarial	n	ax k - s i - u - n ax - r i - a1 l
jubilar	n	Z u - B i - l a1
rotunditat	n	rr u - t u n - d i - t a1 t
privatitzar	n	p r i - B ax - t i d - z a1
col·legiat	n	k u - l ax - Z i - a1 t
tomb	n	t o1 m
metàl·lic	n	m ax - t a1 - l i k
ideat	n	i - D e - a1 t
indefinit	n	i n - d ax - f i - n i1 t
genèticament	n	Z ax - n E - t i - k ax - m e1 n
dotacions	n	d u - t ax - s i - o1 n s
fisc	n	f i1 s k
navalla	n	n ax - B a1 - L ax
menú	n	m ax - n u1
abonaments	n	ax - B u - n ax - m e1 n s
bici	n	b i1 - s i
accelerat	n	ax k - s ax - l ax - r a1 t
gravats	n	g r ax - B a1 t s
casual	n	k ax - z u - a1 l
paràlisi	n	p ax - r a1 - l i - z i
desplomar	n	d ax s - p l u - m a1
indonesi	n	i n - d u - n E1 - z i
rendibilitzar	n	rr ax n - d i - B i - l i d - z a1
danyar	n	d ax - J a1
cívica	n	s i1 - B i - k ax
comerciant	n	k u - m ax rr - s i - a1 n
neutralitzar	n	n ax uw - t r ax - l i d - z a1
insuficiència	n	i n - s u - f i - s i - E1 n - s i - ax
excarceració	n	ax k s - k ax rr - s ax - r ax - s i - o1
gal·lès	n	g ax - l E1 s
convencions	n	k u m - b ax n - s i - o1 n s
manxec	n	m ax n - S E1 k
gasta	n	g a1 s - t ax
encant	n	ax N - k a1 n
tics	n	t i1 k s
xocs	n	S O1 k s
oliva	n	u - l i1 - B ax
escurçar	n	ax s - k u rr - s a1
protestant	n	p r u - t ax s - t a1 n
gratuïtament	n	g r ax - t u - i - t ax - m e1 n
logístic	n	l u - Z i1 s - t i k
glamur	n	g l ax - m u1
tertúlia	n	t ax rr - t u1 - l i - ax
fèretre	n	f E1 - r ax - t r ax
busos	n	b u1 - z u s
noves	n	n O1 - B ax s
seduir	n	s ax - D u - i1
enfadat	n	ax m - f ax - D a1 t
tinença	n	t i - n E1 n - s ax
coartada	n	k u - ax rr - t a1 - D ax
seguici	n	s ax - G i1 - s i
funerals	n	f u - n ax - r a1 l s
permanentment	n	p ax rr - m ax - n e m - m e1 n
aliades	n	ax - l i - a1 - D ax s
eutanàsia	n	ax uw - t ax - n a1 - z i - ax
proveïdor	n	p r u - B ax - i - D o1
arqueòlegs	n	a rr - k ax - O1 - l ax k s
penyes	n	p E1 - J ax s
paròdia	n	p ax - r O1 - D i - ax
robot	n	rr u - B O1 t
liquiditat	n	l i - k i - D i - t a1 t
foscor	n	f u s - k o1
debutarà	n	d ax - B u - t ax - r a1
publicitàries	n	p u - B l i - s i - t a1 - r i - ax s
ral·li	n	rr a1 - l i
surrealista	n	s u - rr e - ax - l i1 s - t ax
al·legat	n	ax - l ax - G a1 t
núvia	n	n u1 - B i - ax
ambientada	n	ax m - b i - ax n - t a1 - D ax
bèl·lic	n	b E1 - l i k
radiofònic	n	rr a - D i - u - f O1 - n i k
coordinada	n	k u - u r - D i - n a1 - D ax
sud-africà	n	s u - t ax - f r i - k a1
contesa	n	k u n - t E1 - z ax
atracaments	n	ax - t r ax - k ax - m e1 n s
columnista	n	k u - l u m - n i1 s - t ax
comandants	n	k u - m ax n - d a1 n s
marcianes	n	m ax rr - s i - a1 - n ax s
domèstics	n	d u - m E1 s - t i k s
desestimat	n	d ax - z ax s - t i - m a1 t
tendes	n	t e1 n - d ax s
connectat	n	k u n - n ax k - t a1 t
eclipsi	n	ax - k l i1 p - s i
butlletí	n	b u L - L ax - t i1
brutalitat	n	b r u - t ax - l i - t a1 t
desembarcar	n	d ax - z ax m - b ax rr - k a1
tocs	n	t O1 k s
finalitza	n	f i - n ax - l i1 d - z ax
retret	n	rr ax - t r e1 t
encoratjar	n	ax N - k u - r ax d - Z a1
esplèndida	n	ax s - p l E1 n - d i - D ax
presidenciable	n	p r e - s i - D ax n - s i - a1 b - b l ax
mítica	n	m i1 - t i - k ax
ucraïnès	n	u - k r ax - i - n E1 s
illa	n	i1 - L ax
requeriment	n	rr ax - k ax - r i - m e1 n
regata	n	rr ax - G a1 - t ax
consensuada	n	k u n - s ax n - s u - a1 - D ax
maquillatge	n	m ax - k i - L a1 d - Z ax
comptable	n	k u m - t a1 b - b l ax
apassionat	n	ax - p ax - s i - u - n a1 t
anul·lació	n	ax - n u - l ax - s i - o1
alarmes	n	ax - l a1 rr - m ax s
confeccionar	n	k u m - f ax k - s i - u - n a1
repassa	n	rr ax - p a1 - s ax
ultima	n	u l - t i1 - m ax
vergonyós	n	b ax r - G u - J o1 s
bomber	n	b u m - b e1
desallotjats	n	d ax - z ax - L u d - Z a1 t s
responsabilitza	n	rr ax s - p u n - s ax - B i - l i1 d - z ax
rocker	n	rr u - k e1
logotip	n	l u - G u - t i1 p
monòleg	n	m u - n O1 - l ax k
organitzadora	n	u r - G ax - n i d - z ax - D o1 - r ax
paritat	n	p ax - r i - t a1 t
deté	n	d ax - t e1
detectiu	n	d ax - t ax k - t i1 uw
triangle	n	t r i - a1 N - g l ax
extorsió	n	ax k s - t u rr - s i - o1
fin	n	f i1 n
perímetre	n	p ax - r i1 - m ax - t r ax
tu	n	t u1
bessones	n	b ax - s o1 - n ax s
coliseu	n	k u - l i - z E1 uw
descontrol	n	d ax s - k u n - t r O1 l
inquieta	n	i N - k i - e1 - t ax
denegar	n	d ax - n ax - G a1
sacsejar	n	s ax k - s ax - Z a1
extremeny	n	ax k s - t r ax - m E1 J
sirià	n	s i - r i - a1
galàxies	n	g ax - l a1 k - s i - ax s
sospitosa	n	s u s - p i - t o1 - z ax
fantàstica	n	f ax n - t a1 s - t i - k ax
anima	n	ax - n i1 - m ax
contribuent	n	k u n - t r i - B u - e1 n
preelectoral	n	p r e - ax - l ax k - t u - r a1 l
aparcats	n	ax - p ax rr - k a1 t s
repetidament	n	rr ax - p ax - t i - D ax - m e1 n
desactivar	n	d ax - z ax k - t i - B a1
meravellosa	n	m ax - r ax - B ax - L o1 - z ax
mandataris	n	m ax n - d ax - t a1 - r i s
prestigiosos	n	p r ax s - t i - Z i - o1 - z u s
escrúpols	n	ax s - k r u1 - p u l s
orina	n	u - r i1 - n ax
inspeccionar	n	i n s - p ax k - s i - u - n a1
orquestres	n	u rr - k e1 s - t r ax s
consultat	n	k u n - s u l - t a1 t
indefinits	n	i n - d ax - f i - n i1 t s
rugby	n	rr u1 g - b i
sincer	n	s i n - s e1
reporters	n	rr ax - p u rr - t e1 s
càrtel	n	k a1 rr - t ax l
programada	n	p r u - G r ax - m a1 - D ax
exmarit	n	E g z - m ax - r i1 t
rendibles	n	rr ax n - d i1 b - b l ax s
mútuament	n	m u - t u - ax - m e1 n
forenses	n	f u - r E1 n - s ax s
entrevistarà	n	ax n - t r ax - B i s - t ax - r a1
neutral	n	n ax uw - t r a1 l
cabines	n	k ax - B i1 - n ax s
diable	n	d i - a1 b - b l ax
vedella	n	b ax - D e1 - L ax
vela	n	b E1 - l ax
internament	n	i n - t ax rr - n ax - m e1 n
contrapartida	n	k O n - t r ax - p ax rr - t i1 - D ax
man	n	m a1 n
rebel·lió	n	rr ax - B ax - l i - o1
accidentat	n	ax k - s i - D ax n - t a1 t
inflacionistes	n	i m - f l ax - s i - u - n i1 s - t ax s
nomenaments	n	n u - m ax - n ax - m e1 n s
agilitzar	n	ax - Z i - l i d - z a1
demandar	n	d ax - m ax n - d a1
fotografiar	n	f u - t u - G r ax - f i - a1
intimidar	n	i n - t i - m i - D a1
cobriment	n	k u - B r i - m e1 n
paradís	n	p ax - r ax - D i1 s
bronca	n	b r o1 N - k ax
mentir	n	m ax n - t i1
saga	n	s a1 - G ax
artífex	n	ax rr - t i1 - f ax k s
pallasso	n	p ax - L a1 - s u
duquessa	n	d u - k E1 - s ax
diva	n	d i1 - B ax
sobra	n	s O1 - B r ax
exhibeixen	n	ax g - z i - B E1 - S ax n
matrimonial	n	m ax - t r i - m u - n i - a1 l
duplicar	n	d u - p l i - k a1
cascos	n	k a1 s - k u s
seleccionat	n	s ax - l ax k - s i - u - n a1 t
lírica	n	l i1 - r i - k ax
inculpat	n	i N - k u l - p a1 t
xavals	n	S ax - B a1 l s
interrogants	n	i n - t ax - rr u - G a1 n s
sol·liciten	n	s u - l i - s i1 - t ax n
recompondre	n	rr ax - k u m - p O1 n - d r ax
ducs	n	d u1 k s
conflictiu	n	k u m - f l i k - t i1 uw
desastres	n	d ax - z a1 s - t r ax s
fòrums	n	f O1 - r u m s
embarassades	n	ax m - b ax - r ax - s a1 - D ax s
goma	n	g o1 - m ax
arrodonir	n	ax - rr u - D u - n i1
trilogia	n	t r i - l u - Z i1 - ax
sancionador	n	s ax n - s i - u - n ax - D o1
races	n	rr a1 - s ax s
il·lícita	n	i - l i1 - s i - t ax
pausa	n	p a1 uw - z ax
querelles	n	k ax - r e1 - L ax s
intermediació	n	i n - t ax rr - m ax - D i - ax - s i - o1
perdedor	n	p ax r - D ax - D o1
frustrar	n	f r u s - t r a1
afanyar	n	ax - f ax - J a1
presumeix	n	p r ax - z u - m E1 S
entrevistats	n	ax n - t r ax - B i s - t a1 t s
convocatòries	n	k u m - b u - k ax - t O1 - r i - ax s
gelosia	n	Z ax - l u - z i1 - ax
estabilitzar	n	ax s - t ax - B i - l i d - z a1
urna	n	u1 rr - n ax
foc	n	f O1 k
rodalia	n	rr u - D ax - l i1 - ax
unificar	n	u - n i - f i - k a1
golejar	n	g u - l ax - Z a1
desqualificacions	n	d ax s - k w ax - l i - f i - k ax - s i - o1 n s
programats	n	p r u - G r ax - m a1 t s
anorèxia	n	ax - n u - r E1 k - s i - ax
romanesos	n	rr u - m ax - n E1 - z u s
rellevar	n	rr ax - L ax - B a1
honestedat	n	u - n ax s - t ax - D a1 t
beisbol	n	b ax j z - B O1 l
burocràcia	n	b u - r u - k r a1 - s i - ax
periodística	n	p ax - r i - u - D i1 s - t i - k ax
punk	n	p u1 N k
motocicletes	n	m u - t u - s i - k l E1 - t ax s
pe	n	p e1
violat	n	b i - u - l a1 t
embús	n	ax m - b u1 s
suplir	n	s u - p l i1
intolerable	n	i n - t u - l ax - r a1 b - b l ax
dialogant	n	d i - ax - l u - G a1 n
bateries	n	b ax - t ax - r i1 - ax s
angoixant	n	ax N - g u - S a1 n
quintet	n	k i n - t E1 t
vincula	n	b i N - k u1 - l ax
horària	n	u - r a1 - r i - ax
teòricament	n	t ax - O - r i - k ax - m e1 n
canadenca	n	k ax - n ax - D E1 N - k ax
blindats	n	b l i n - d a1 t s
escorxador	n	ax s - k u rr - S ax - D o1
australians	n	ax uw s - t r ax - l i - a1 n s
llatinoamericà	n	L ax - t i - n u - ax - m ax - r i - k a1
sufocar	n	s u - f u - k a1
agraeix	n	ax - G r ax - E1 S
plasmar	n	p l ax z - m a1
flauta	n	f l a1 uw - t ax
refrigeració	n	rr ax - f r i - Z ax - r ax - s i - o1
clandestins	n	k l ax n - d ax s - t i1 n s
emblemàtica	n	ax m - b l ax - m a1 - t i - k ax
disculpar	n	d i s - k u l - p a1
argumentant	n	ax r - G u - m ax n - t a1 n
timó	n	t i - m o1
prepotència	n	p r ax - p u - t E1 n - s i - ax
equipatge	n	ax - k i - p a1 d - Z ax
astronautes	n	ax s - t r u - n a1 uw - t ax s
rebel·lia	n	rr ax - B ax - l i1 - ax
premissa	n	p r ax - m i1 - s ax
vacants	n	b ax - k a1 n s
escolarització	n	ax s - k u - l ax - r i d - z ax - s i - o1
urgentment	n	u rr - Z e m - m e1 n
tenacitat	n	t ax - n ax - s i - t a1 t
rol	n	rr O1 l
caixer	n	k ax - S e1
estatura	n	ax s - t ax - t u1 - r ax
consistència	n	k u n - s i s - t E1 n - s i - ax
combustibles	n	k u m - b u s - t i1 b - b l ax s
urbs	n	u1 rr p s
acreditat	n	ax - k r ax - D i - t a1 t
venjar	n	b ax n - Z a1
irritació	n	i - rr i - t ax - s i - o1
conversar	n	k u m - b ax rr - s a1
barbaritat	n	b ax r - B ax - r i - t a1 t
riuada	n	rr i - w a1 - D ax
agraït	n	ax - G r ax - i1 t
dictaminar	n	d i k - t ax - m i - n a1
furgonetes	n	f u r - G u - n E1 - t ax s
assassinada	n	ax - s ax - s i - n a1 - D ax
normalitzar	n	n u rr - m ax - l i d - z a1
vacant	n	b ax - k a1 n
cànon	n	k a1 - n u n
contracta	n	k u n - t r a1 k - t ax
conciliador	n	k u n - s i - l i - ax - D o1
atent	n	ax - t e1 n
ambulatori	n	ax m - b u - l ax - t O1 - r i
hipocresia	n	i - p u - k r ax - z i1 - ax
violoncel	n	b i - u - l u n - s E1 l
folk	n	f O1 l k
desmantellament	n	d ax z - m ax n - t e - L ax - m e1 n
entregaran	n	ax n - t r ax - G ax - r a1 n
vivències	n	b i - B E1 n - s i - ax s
exalts	n	E g - z a1 l s
ambicions	n	ax m - b i - s i - o1 n s
nòmica	n	n O1 - m i - k ax
nandrolona	n	n ax n - d r u - l o1 - n ax
desmenteix	n	d ax z - m ax n - t E1 S
farines	n	f ax - r i1 - n ax s
reclús	n	rr ax - k l u1 s
reivindiquen	n	rr ax - i - B i n - d i1 - k ax n
puntualitza	n	p u n - t u - ax - l i1 d - z ax
complicacions	n	k u m - p l i - k ax - s i - o1 n s
arbitral	n	ax r - B i - t r a1 l
aliar	n	ax - l i - a1
subsidi	n	s u p - s i1 - D i
calefacció	n	k ax - l ax - f ax k - s i - o1
fluïdesa	n	f l u - i - D E1 - z ax
mestissatge	n	m ax s - t i - s a1 d - Z ax
hostilitat	n	u s - t i - l i - t a1 t
pirata	n	p i - r a1 - t ax
gorra	n	g O1 - rr ax
bonificacions	n	b u - n i - f i - k ax - s i - o1 n s
regularitzar	n	rr ax - G u - l ax - r i d - z a1
èxtasi	n	E1 k s - t ax - z i
reunificació	n	rr ax - u - n i - f i - k ax - s i - o1
sabotatge	n	s ax - B u - t a1 d - Z ax
eurozona	n	E uw - r u - z o1 - n ax
cartilla	n	k ax rr - t i1 - L ax
esquerdes	n	ax s - k E1 r - D ax s
batuta	n	b ax - t u1 - t ax
mocions	n	m u - s i - o1 n s
firmen	n	f i1 rr - m ax n
hispana	n	i s - p a1 - n ax
catàstrofes	n	k ax - t a1 s - t r u - f ax s
regnat	n	rr ax g - n a1 t
vencedors	n	b ax n - s ax - D o1 s
adjacents	n	ax d - Z ax - s e1 n s
patologies	n	p ax - t u - l u - Z i1 - ax s
assassinades	n	ax - s ax - s i - n a1 - D ax s
trasplantaments	n	t r ax s - p l ax n - t ax - m e1 n s
júnior	n	Z u1 - n i - o rr
devolucions	n	d ax - B u - l u - s i - o1 n s
llast	n	L a1 s t
discrepar	n	d i s - k r ax - p a1
gravades	n	g r ax - B a1 - D ax s
argumenten	n	ax r - G u - m e1 n - t ax n
pirateria	n	p i - r ax - t ax - r i1 - ax
fundadors	n	f u n - d ax - D o1 s
enlairament	n	ax n - l ax j - r ax - m e1 n
beneficiats	n	b ax - n ax - f i - s i - a1 t s
inquilins	n	i N - k i - l i1 n s
ca	n	k a1
milionàries	n	m i - l i - u - n a1 - r i - ax s
reaparició	n	rr e - ax - p ax - r i - s i - o1
cabaret	n	k ax - B ax - r E1 t
annex	n	ax n - n E1 k s
canària	n	k ax - n a1 - r i - ax
nadalenques	n	n ax - D ax - l E1 N - k ax s
néta	n	n e1 - t ax
cambrer	n	k ax m - b r e1
accessible	n	ax k - s ax - s i1 b - b l ax
exiliat	n	ax g - z i - l i - a1 t
especialitats	n	ax s - p ax - s i - ax - l i - t a1 t s
saxofonista	n	s ax k - s u - f u - n i1 s - t ax
humanitari	n	u - m ax - n i - t a1 - r i
ciència-ficció	n	s i - E n - s i - ax - f i k - s i - o1
sol·licitarà	n	s u - l i - s i - t ax - r a1
immers	n	i m - m E1 rr s
micròfon	n	m i - k r O1 - f u n
retocs	n	rr ax - t O1 k s
desdoblament	n	d ax z - D u b - b l ax - m e1 n
furgó	n	f u r - G o1
abaratir	n	ax - B ax - r ax - t i1
simfonia	n	s i m - f u - n i1 - ax
abstencions	n	ax p s - t ax n - s i - o1 n s
percussió	n	p ax rr - k u - s i - o1
cafeteria	n	k ax - f ax - t ax - r i1 - ax
hàbil	n	a1 - B i l
milles	n	m i1 - L ax s
ulls	n	u1 L s
orgullosos	n	u r - G u - L o1 - z u s
ajustaments	n	ax - Z u s - t ax - m e1 n s
suplement	n	s u - p l ax - m e1 n
irlandesa	n	i rr - l ax n - d E1 - z ax
triomfa	n	t r i - o1 m - f ax
cul	n	k u1 l
regularment	n	rr ax - G u - l a rr - m e1 n
càntabre	n	k a1 n - t ax - B r ax
literalment	n	l i - t ax - r a l - m e1 n
respectuós	n	rr ax s - p ax k - t u - o1 s
guipuscoana	n	g i - p u s - k u - a1 - n ax
entregada	n	e n - t r ax - G a1 - D ax
traspassat	n	t r ax s - p ax - s a1 t
prioritària	n	p r i - u - r i - t a1 - r i - ax
tributs	n	t r i - B u1 t s
perillositat	n	p ax - r i - L u - z i - t a1 t
arxipèlag	n	ax rr - S i - p E1 - l ax k
matriculacions	n	m ax - t r i - k u - l ax - s i - o1 n s
verdaderament	n	b ax r - D ax - D e - r ax - m e1 n
notablement	n	n u - t a b - b l ax - m e1 n
sinceritat	n	s i n - s ax - r i - t a1 t
desmentit	n	d ax z - m ax n - t i1 t
desavantatge	n	d ax - z ax - B ax n - t a1 d - Z ax
doblat	n	d u b - b l a1 t
col·leccionista	n	k u - l ax k - s i - u - n i1 s - t ax
abonat	n	ax - B u - n a1 t
sonor	n	s u - n o1 rr
periple	n	p ax - r i1 - p l ax
gravada	n	g r ax - B a1 - D ax
sobren	n	s o1 - B r ax n
barates	n	b ax - r a1 - t ax s
oferiment	n	u - f ax - r i - m e1 n
frescor	n	f r ax s - k o1
moralment	n	m u - r a l - m e1 n
explícitament	n	ax k s - p l i - s i - t ax - m e1 n
coets	n	k u - E1 t s
inclinar	n	i N - k l i - n a1
be	n	b e1
tonto	n	t o1 n - t u
realitzadora	n	rr e - ax - l i d - z ax - D o1 - r ax
enormement	n	ax - n o rr - m ax - m e1 n
admiradors	n	ax d - m i - r ax - D o1 s
xineses	n	S i - n E1 - z ax s
ne	n	n e1
supòsit	n	s u - p O1 - z i t
estela	n	ax s - t E1 - l ax
somnis	n	s O1 m - n i s
calçat	n	k ax l - s a1 t
descartada	n	d ax s - k ax rr - t a1 - D ax
baríton	n	b ax - r i1 - t u n
caçadors	n	k ax - s ax - D o1 s
barcelonistes	n	b ax rr - s ax - l u - n i1 s - t ax s
posposar	n	p u s - p u - z a1
edil	n	ax - D i1 l
prescripció	n	p r ax s - k r i p - s i - o1
desistir	n	d ax - z i s - t i1
clamor	n	k l ax - m o1
narcotraficants	n	n ax rr - k u - t r ax - f i - k a1 n s
franquistes	n	f r ax N - k i1 s - t ax s
folis	n	f O1 - l i s
reivindicatiu	n	rr ax - i - B i n - d i - k ax - t i1 uw
malària	n	m ax - l a1 - r i - ax
índia	n	i1 n - d i - ax
actualitzar	n	ax k - t u - ax - l i d - z a1
presumpció	n	p r ax - z u m - s i - o1
sostenibilitat	n	s u s - t ax - n i - B i - l i - t a1 t
eliminatòries	n	ax - l i - m i - n ax - t O1 - r i - ax s
afortunat	n	ax - f u rr - t u - n a1 t
concessionaris	n	k u n - s ax - s i - u - n a1 - r i s
autoestima	n	a uw - t u - ax s - t i1 - m ax
cuir	n	k u1 j rr
electrodomèstics	n	ax - l ax k - t r u - D u - m E1 s - t i k s
impulsors	n	i m - p u l - s o1 s
neutralitat	n	n ax uw - t r ax - l i - t a1 t
entusiasta	n	ax n - t u - z i - a1 s - t ax
tributària	n	t r i - B u - t a1 - r i - ax
comptables	n	k u m - t a1 b - b l ax s
estatueta	n	ax s - t ax - t u - E1 - t ax
emocionant	n	ax - m u - s i - u - n a1 n
obsessionat	n	u p - s ax - s i - u - n a1 t
avisos	n	ax - B i1 - z u s
cordial	n	k u r - D i - a1 l
cancel·lació	n	k ax n - s ax - l ax - s i - o1
minusvàlids	n	m i - n u z - B a1 - l i t s
cel	n	s E1 l
lamenten	n	l ax - m e1 n - t ax n
arranjaments	n	ax - rr ax n - Z ax - m e1 n s
caces	n	k a1 - s ax s
premiada	n	p r ax - m i - a1 - D ax
tarifària	n	t ax - r i - f a1 - r i - ax
adequadament	n	ax - D ax - k w a - D ax - m e1 n
finalitzarà	n	f i - n ax - l i d - z ax - r a1
far	n	f a1 rr
rapats	n	rr ax - p a1 t s
minorista	n	m i - n u - r i1 s - t ax
contractada	n	k u n - t r ax k - t a1 - D ax
comissionat	n	k u - m i - s i - u - n a1 t
desafiaments	n	d ax - z ax - f i - ax - m e1 n s
luxós	n	l u k - s o1 s
trànsfuga	n	t r a1 n s - f u - G ax
energètics	n	ax - n ax rr - Z E1 - t i k s
bufet	n	b u - f E1 t
vides	n	b i1 - D ax s
automobilística	n	a uw - t u - m u - B i - l i1 s - t i - k ax
avaries	n	ax - B ax - r i1 - ax s
tractors	n	t r ax k - t o1 s
populista	n	p u - p u - l i1 s - t ax
lleidatana	n	L ax j - D ax - t a1 - n ax
remat	n	rr ax - m a1 t
evasió	n	ax - B ax - z i - o1
argumental	n	ax r - G u - m ax n - t a1 l
desordre	n	d ax - z o1 r - D r ax
postals	n	p u s - t a1 l s
suborns	n	s u - B o1 rr n s
patologia	n	p ax - t u - l u - Z i1 - ax
doblegar	n	d u b - b l ax - G a1
enganxat	n	ax N - g ax n - S a1 t
connectarà	n	k u n - n ax k - t ax - r a1
assequible	n	ax - s ax - k i1 b - b l ax
fullets	n	f u - L E1 t s
partidària	n	p ax rr - t i - D a1 - r i - ax
forn	n	f o1 rr n
calibre	n	k ax - l i1 - B r ax
domiciliari	n	d u - m i - s i - l i - a1 - r i
casetes	n	k ax - z E1 - t ax s
ambaixades	n	ax m - b ax - S a1 - D ax s
comitès	n	k u - m i - t E1 s
guerristes	n	g ax - rr i1 s - t ax s
esquiar	n	ax s - k i - a1
arxivat	n	ax rr - S i - B a1 t
banquer	n	b ax N - k e1
rotació	n	rr u - t ax - s i - o1
noruega	n	n u - r u - E1 - G ax
etiquetes	n	ax - t i - k E1 - t ax s
veterinaris	n	b ax - t ax - r i - n a1 - r i s
gestionarà	n	Z ax s - t i - u - n ax - r a1
sumaris	n	s u - m a1 - r i s
actualització	n	ax k - t u - ax - l i d - z ax - s i - o1
farts	n	f a1 rr s
uruguaià	n	u - r u - G w ax - y a1
cantaor	n	k ax n - t ax - o1
perplexitat	n	p ax rr - p l ax k - s i - t a1 t
viceprimer	n	b i - s ax - p r i - m e1
triomfador	n	t r i - u m - f ax - D o1
metalls	n	m ax - t a1 L s
confidencialitat	n	k u m - f i - D ax n - s i - ax - l i - t a1 t
reconduir	n	rr ax - k u n - d u - i1
queixat	n	k ax - S a1 t
estralls	n	ax s - t r a1 L s
antidopatge	n	a n - t i - D u - p a1 d - Z ax
enjudiciament	n	ax n - Z u - D i - s i - ax - m e1 n
contusions	n	k u n - t u - z i - o1 n s
depreciació	n	d ax - p r ax - s i - ax - s i - o1
subhastes	n	s u - B a1 s - t ax s
restringir	n	rr ax s - t r i n - Z i1
emocionar	n	ax - m u - s i - u - n a1
facultatius	n	f ax - k u l - t ax - t i1 uw s
lamentablement	n	l ax - m ax n - t a b - b l ax - m e1 n
exèrcits	n	ax g - z E1 rr - s i t s
excusar	n	ax k s - k u - z a1
càsting	n	k a1 s - t i N
abertzales	n	ax - B ax rr d - z a1 - l ax s
corruptes	n	k u - rr u1 p - t ax s
amistosos	n	ax - m i s - t o1 - z u s
rescatats	n	rr ax s - k ax - t a1 t s
alberga	n	ax l - B E1 r - G ax
incompatibilitats	n	i N - k u m - p ax - t i - B i - l i - t a1 t s
enllaços	n	ax J - L a1 - s u s
escopeta	n	ax s - k u - p E1 - t ax
melodrama	n	m ax - l u - D r a1 - m ax
emissor	n	ax - m i - s o1
morbo	n	m O1 r - B u
sobirà	n	s u - B i - r a1
defraudar	n	d ax - f r ax uw - D a1
socorristes	n	s u - k u - rr i1 s - t ax s
dimissions	n	d i - m i - s i - o1 n s
traïdor	n	t r ax - i - D o1
televisives	n	t ax - l ax - B i - z i1 - B ax s
segells	n	s ax - Z e1 L s
segrestos	n	s ax - G r e1 s - t u s
xecs	n	S E1 k s
elogia	n	ax - l u - Z i1 - ax
insígnia	n	i n - s i1 g - n i - ax
pèssim	n	p E1 - s i m
especular	n	ax s - p ax - k u - l a1
escrutini	n	ax s - k r u - t i1 - n i
judicialment	n	Z u - D i - s i - a l - m e1 n
idònia	n	i - D O1 - n i - ax
guitarres	n	g i - t a1 - rr ax s
èpica	n	E1 - p i - k ax
perdedors	n	p ax r - D ax - D o1 s
telecomèdia	n	t E - l ax - k u - m E1 - D i - ax
ingerència	n	i n - Z ax - r E1 n - s i - ax
acompanyants	n	ax - k u m - p ax - J a1 n s
triomfat	n	t r i - u m - f a1 t
cisterna	n	s i s - t E1 rr - n ax
reinserció	n	rr ax - i n - s ax rr - s i - o1
immobilisme	n	i m - m u - B i - l i1 z - m ax
entredit	n	ax n - t r ax - D i1 t
odissea	n	u - D i - s e1 - ax
beneficien	n	b ax - n ax - f i - s i1 - ax n
fullet	n	f u - L E1 t
exculpar	n	ax k s - k u l - p a1
cavaller	n	k ax - B ax - L e1
caseta	n	k ax - z E1 - t ax
antidroga	n	a n - t i - D r O1 - G ax
finalitzi	n	f i - n ax - l i1 d - z i
vicesecretari	n	b i - s ax - s ax - k r ax - t a1 - r i
copiar	n	k u - p i - a1
degoteig	n	d ax - G u - t E1 tS
envasos	n	ax m - b a1 - z u s
croats	n	k r u - a1 t s
extermini	n	ax k s - t ax rr - m i1 - n i
incerteses	n	i n - s ax rr - t E1 - z ax s
leucèmia	n	l ax uw - s E1 - m i - ax
ajustada	n	ax - Z u s - t a1 - D ax
xoca	n	S O1 - k ax
internat	n	i n - t ax rr - n a1 t
suspèn	n	s u s - p E1 n
energètica	n	ax - n ax rr - Z E1 - t i - k ax
congelat	n	k u n - Z ax - l a1 t
pelegrinatge	n	p ax - l ax - G r i - n a1 d - Z ax
regidoria	n	rr ax - Z i - D u - r i1 - ax
cooperar	n	k u - u - p ax - r a1
forçós	n	f u rr - s o1 s
caçar	n	k ax - s a1
prostituta	n	p r u s - t i - t u1 - t ax
nominació	n	n u - m i - n ax - s i - o1
coloms	n	k u - l o1 m s
reformistes	n	rr ax - f u rr - m i1 s - t ax s
patriarca	n	p ax - t r i - a1 rr - k ax
tabaqueres	n	t ax - B ax - k e1 - r ax s
preservació	n	p r ax - z ax r - B ax - s i - o1
ensorrament	n	ax n - s u - rr ax - m e1 n
cunyat	n	k u - J a1 t
radar	n	rr ax - D a1 rr
visats	n	b i - z a1 t s
canonades	n	k ax - n u - n a1 - D ax s
combois	n	k u m - b O1 j s
improvisar	n	i m - p r u - B i - z a1
corejar	n	k u - r ax - Z a1
metàl·lica	n	m ax - t a1 - l i - k ax
reanimar	n	rr e - ax - n i - m a1
devoció	n	d ax - B u - s i - o1
pelegrins	n	p ax - l ax - G r i1 n s
envestir	n	ax m - b ax s - t i1
elogi	n	ax - l O1 - Z i
fluid	n	f l u1 j t
raonables	n	rr ax - u - n a1 b - b l ax s
vicepresidents	n	b i - s ax - p r ax - z i - D e1 n s
governadors	n	g u - B ax rr - n ax - D o1 s
beneficiaran	n	b ax - n ax - f i - s i - ax - r a1 n
apologia	n	ax - p u - l u - Z i1 - ax
assaltants	n	ax - s ax l - t a1 n s
mul·là	n	m u - l a1
relaxat	n	rr ax - l ax k - s a1 t
trampes	n	t r a1 m - p ax s
internacionalment	n	i n - t ax rr - n ax - s i - u - n a l - m e1 n
felicitació	n	f ax - l i - s i - t ax - s i - o1
nevada	n	n ax - B a1 - D ax
notificació	n	n u - t i - f i - k ax - s i - o1
pàrquings	n	p a1 rr - k i N s
esquiador	n	ax s - k i - ax - D o1
ratolins	n	rr ax - t u - l i1 n s
esquís	n	ax s - k i1 s
projectils	n	p r u - Z ax k - t i1 l s
epicentre	n	ax - p i - s e1 n - t r ax
disputada	n	d i s - p u - t a1 - D ax
esgotament	n	ax z - G u - t ax - m e1 n
presidia	n	p r ax - z i - D i1 - ax
exportadors	n	ax k s - p u rr - t ax - D o1 s
intensament	n	i n - t E n - s ax - m e1 n
esglaó	n	ax z - G l ax - o1
padrí	n	p ax - D r i1
judicatura	n	Z u - D i - k ax - t u1 - r ax
assessorar	n	ax - s ax - s u - r a1
debilitar	n	d ax - B i - l i - t a1
empresonament	n	ax m - p r ax - z u - n ax - m e1 n
democràticament	n	d ax - m u - k r a - t i - k ax - m e1 n
puta	n	p u1 - t ax
desànim	n	d ax - z a1 - n i m
acatar	n	ax - k ax - t a1
revolt	n	rr ax - B O1 l
motociclisme	n	m u - t u - s i - k l i1 z - m ax
von	n	b o1 n
escalfament	n	ax s - k ax l - f ax - m e1 n
esclavitud	n	ax s - k l ax - B i - t u1 t
transbordador	n	t r ax n z - B u r - D ax - D o1
subscripció	n	s u p s - k r i p - s i - o1
solucionat	n	s u - l u - s i - u - n a1 t
prorrogar	n	p r u - rr u - G a1
desarticulat	n	d ax - z ax rr - t i - k u - l a1 t
emergents	n	ax - m ax rr - Z e1 n s
disfrutat	n	d i s - f r u - t a1 t
consumar	n	k u n - s u - m a1
baix	n	b a1 S
fallit	n	f ax - L i1 t
imparteix	n	i m - p ax rr - t E1 S
apostant	n	ax - p u s - t a1 n
itinerant	n	i - t i - n ax - r a1 n
inculpats	n	i N - k u l - p a1 t s
culminarà	n	k u l - m i - n ax - r a1
cuiner	n	k u j - n e1
unionista	n	u - n i - u - n i1 s - t ax
tontos	n	t o1 n - t u s
repunt	n	rr ax - p u1 n
propagació	n	p r u - p ax - G ax - s i - o1
altercats	n	ax l - t ax rr - k a1 t s
desemborsament	n	d ax - z ax m - b u rr - s ax - m e1 n
matricular	n	m ax - t r i - k u - l a1
controvertida	n	k u n - t r u - B ax rr - t i1 - D ax
despatxar	n	d ax s - p ax t - S a1
redactor	n	rr ax - D ax k - t o1
castellonenc	n	k ax s - t ax - L u - n E1 N
estacionament	n	ax s - t ax - s i - u - n ax - m e1 n
falsificar	n	f ax l - s i - f i - k a1
exsenador	n	E k - s ax - n ax - D o1
assemblees	n	ax - s ax m - b l e1 - ax s
blau	n	b l a1 uw
interventors	n	i n - t ax r - B ax n - t o1 s
protector	n	p r u - t ax k - t o1
rancor	n	rr ax N - k o1
ordenances	n	u r - D ax - n a1 n - s ax s
guardonats	n	g w ax r - D u - n a1 t s
incursions	n	i N - k u rr - s i - o1 n s
colze	n	k o1 l - z ax
absoldre	n	ax p - s O1 l - d r ax
temàtics	n	t ax - m a1 - t i k s
biscaïna	n	b i s - k ax - i1 - n ax
incomplert	n	i N - k u m - p l E1 rr t
incórrer	n	i N - k o1 - rr ax
qui	n	k i1
estudiantil	n	ax s - t u - D i - ax n - t i1 l
licitat	n	l i - s i - t a1 t
mòdul	n	m O1 - D u l
contaminats	n	k u n - t ax - m i - n a1 t s
singularitat	n	s i N - g u - l ax - r i - t a1 t
notificar	n	n u - t i - f i - k a1
cotitza	n	k u - t i1 d - z ax
tramita	n	t r ax - m i1 - t ax
penitenciaris	n	p ax - n i - t ax n - s i - a1 - r i s
espectacularitat	n	ax s - p ax k - t ax - k u - l ax - r i - t a1 t
virtuals	n	b i rr - t u - a1 l s
presumiblement	n	p r ax - z u - m i b - b l ax - m e1 n
petards	n	p ax - t a1 rr s
crims	n	k r i1 m s
assistencials	n	ax - s i s - t ax n - s i - a1 l s
clavegueram	n	k l ax - B ax - G ax - r a1 m
lot	n	l O1 t
pioners	n	p i - u - n e1 s
milicians	n	m i - l i - s i - a1 n s
creuer	n	k r ax - w e1
iraquians	n	i - r ax - k i - a1 n s
allaus	n	ax - L a1 uw s
disciplinari	n	d i - s i - p l i - n a1 - r i
consola	n	k u n - s O1 - l ax
bassa	n	b a1 - s ax
electoralista	n	ax - l ax k - t u - r ax - l i1 s - t ax
dividends	n	d i - B i - D e1 n s
arquitectònic	n	ax rr - k i - t ax k - t O1 - n i k
interposat	n	i n - t ax rr - p u - z a1 t
servidor	n	s ax r - B i - D o1
exregidor	n	E g z - rr ax - Z i - D o1
gresca	n	g r E1 s - k ax
radi	n	rr a1 - D i
contrapartides	n	k O n - t r ax - p ax rr - t i1 - D ax s
emmagatzematge	n	ax m - m ax - G ax d - z ax - m a1 d - Z ax
burla	n	b u1 rr - l ax
submarins	n	s u b - m ax - r i1 n s
estaments	n	ax s - t ax - m e1 n s
inquiet	n	i N - k i - e1 t
ferri	n	f E1 - rr i
incompatibilitat	n	i N - k u m - p ax - t i - B i - l i - t a1 t
investigadora	n	i m - b ax s - t i - G ax - D o1 - r ax
imputacions	n	i m - p u - t ax - s i - o1 n s
àgil	n	a1 - Z i l
xiular	n	S i uw - l a1
fiabilitat	n	f i - ax - B i - l i - t a1 t
pronunciament	n	p r u - n u n - s i - ax - m e1 n
evacuats	n	ax - B ax - k u - a1 t s
intueix	n	i n - t u - E1 S
lavabos	n	l ax - B a1 - B u s
sacrificis	n	s ax - k r i - f i1 - s i s
agilitat	n	ax - Z i - l i - t a1 t
gasten	n	g a1 s - t ax n
inundar	n	i - n u n - d a1
magistral	n	m ax - Z i s - t r a1 l
blanc-i-blava	n	b l a - N i - B l a1 - B ax
expolicia	n	E k s - p u - l i - s i1 - ax
hongarès	n	u N - g ax - r E1 s
ineficàcia	n	i - n ax - f i - k a1 - s i - ax
xous	n	S O1 uw s
replica	n	rr ax - p l i1 - k ax
viure	n	b i1 uw - r ax
asiàtica	n	ax - z i - a1 - t i - k ax
decomís	n	d ax - k u - m i1 s
retratar	n	rr ax - t r ax - t a1
circulatori	n	s i rr - k u - l ax - t O1 - r i
excursió	n	ax k s - k u rr - s i - o1
peripècies	n	p ax - r i - p E1 - s i - ax s
sindicalista	n	s i n - d i - k ax - l i1 s - t ax
saludable	n	s ax - l u - D a1 b - b l ax
botxí	n	b u t - S i1
lúdica	n	l u1 - D i - k ax
atracar	n	ax - t r ax - k a1
pacifista	n	p ax - s i - f i1 s - t ax
aclariment	n	ax - k l ax - r i - m e1 n
can	n	k a1 n
retransmissions	n	rr ax - t r ax n z - m i - s i - o1 n s
panells	n	p ax - n e1 L s
rebentar	n	rr ax - B ax n - t a1
sentenciat	n	s ax n - t ax n - s i - a1 t
esquerrà	n	ax s - k ax - rr a1
cinematogràfics	n	s i - n ax - m ax - t u - G r a1 - f i k s
multitudinari	n	m u l - t i - t u - D i - n a1 - r i
carència	n	k ax - r E1 n - s i - ax
vinculant	n	b i N - k u - l a1 n
prodigi	n	p r u - D i1 - Z i
emmarcar	n	ax m - m ax rr - k a1
reivindicativa	n	rr ax - i - B i n - d i - k ax - t i1 - B ax
pressupostàries	n	p r ax - s u - p u s - t a1 - r i - ax s
jubilacions	n	Z u - B i - l ax - s i - o1 n s
iot	n	y O1 t
imparcialitat	n	i m - p ax rr - s i - ax - l i - t a1 t
convida	n	k u m - b i1 - D ax
seducció	n	s ax - D u k - s i - o1
comèdies	n	k u - m E1 - D i - ax s
puntuació	n	p u n - t u - ax - s i - o1
àngel	n	a1 n - Z ax l
màster	n	m a1 s - t ax
qüestionen	n	k w ax s - t i - o1 - n ax n
cord	n	k O1 rr t
emblemàtics	n	ax m - b l ax - m a1 - t i k s
observatori	n	u p - s ax r - B ax - t O1 - r i
papereta	n	p ax - p ax - r E1 - t ax
malbé	n	m a l - B e1
precari	n	p r ax - k a1 - r i
platea	n	p l ax - t e1 - ax
empipament	n	ax m - p i - p ax - m e1 n
acceleració	n	ax k - s ax - l ax - r ax - s i - o1
estupefaents	n	ax s - t u - p ax - f ax - e1 n s
teràpies	n	t ax - r a1 - p i - ax s
gimnàstica	n	Z i m - n a1 s - t i - k ax
vacunes	n	b ax - k u1 - n ax s
partidistes	n	p ax rr - t i - D i1 s - t ax s
escèniques	n	ax - s E1 - n i - k ax s
injectar	n	i n - Z ax k - t a1
auguren	n	ax uw - G u1 - r ax n
coaccions	n	k u - ax k - s i - o1 n s
replegament	n	rr ax - p l ax - G ax - m e1 n
invalidesa	n	i m - b ax - l i - D E1 - z ax
alumini	n	ax - l u - m i1 - n i
arrestos	n	ax - rr e1 s - t u s
liderada	n	l i - D ax - r a1 - D ax
desmantellar	n	d ax z - m ax n - t ax - L a1
natació	n	n ax - t ax - s i - o1
protagonitzats	n	p r u - t ax - G u - n i d - z a1 t s
canonada	n	k ax - n u - n a1 - D ax
cèntric	n	s E1 n - t r i k
inexplicable	n	i - n ax k s - p l i - k a1 b - b l ax
prínceps	n	p r i1 n - s ax p s
favorites	n	f ax - B u - r i1 - t ax s
connivència	n	k u n - n i - B E1 n - s i - ax
segregació	n	s ax - G r ax - G ax - s i - o1
eufòric	n	ax uw - f O1 - r i k
cinematogràfiques	n	s i - n ax - m ax - t u - G r a1 - f i - k ax s
radiofònica	n	rr a - D i - u - f O1 - n i - k ax
evidencia	n	ax - B i - D ax n - s i1 - ax
matriculats	n	m ax - t r i - k u - l a1 t s
baròmetre	n	b ax - r O1 - m ax - t r ax
humiliant	n	u - m i - l i - a1 n
màscara	n	m a1 s - k ax - r ax
avalat	n	ax - B ax - l a1 t
festivitat	n	f ax s - t i - B i - t a1 t
cíviques	n	s i1 - B i - k ax s
novaiorquesa	n	n u - B ax - y u rr - k E1 - z ax
nadalenca	n	n ax - D ax - l E1 N - k ax
barcelonisme	n	b ax rr - s ax - l u - n i1 z - m ax
demores	n	d ax - m o1 - r ax s
xaval	n	S ax - B a1 l
diabetis	n	d i - ax - B E1 - t i s
suburbà	n	s u - p u r - B a1
compromissaris	n	k u m - p r u - m i - s a1 - r i s
malaguenya	n	m ax - l ax - G E1 - J ax
severa	n	s ax - B e1 - r ax
exhibit	n	ax g - z i - B i1 t
indefinició	n	i n - d ax - f i - n i - s i - o1
castrense	n	k ax s - t r E1 n - s ax
defunció	n	d ax - f u n - s i - o1
patins	n	p ax - t i1 n s
madur	n	m ax - D u1
escandalós	n	ax s - k ax n - d ax - l o1 s
espectre	n	ax s - p e1 k - t r ax
ires	n	i1 - r ax s
retrospectiva	n	rr ax - t r u s - p ax k - t i1 - B ax
lamentava	n	l ax - m ax n - t a1 - B ax
premier	n	p r e - m i - e1
companyes	n	k u m - p a1 - J ax s
alertat	n	ax - l ax rr - t a1 t
trasllats	n	t r ax z - L a1 t s
gat	n	g a1 t
felicitacions	n	f ax - l i - s i - t ax - s i - o1 n s
zapatistes	n	z ax - p ax - t i1 s - t ax s
pregó	n	p r ax - G o1
fiasco	n	f i - a1 s - k u
bombo	n	b o1 m - b u
processó	n	p r u - s ax - s o1
colpista	n	k u l - p i1 s - t ax
desbordat	n	d ax z - B u r - D a1 t
finestreta	n	f i - n ax s - t r E1 - t ax
novel·lista	n	n u - B ax - l i1 s - t ax
reactivació	n	rr e - ax k - t i - B ax - s i - o1
titlla	n	t i1 L - L ax
contradiu	n	k u n - t r ax - D i1 uw
jurar	n	Z u - r a1
enllaçar	n	ax J - L ax - s a1
turó	n	t u - r o1
beneplàcit	n	b e - n ax - p l a1 - s i t
londinenca	n	l u n - d i - n E1 N - k ax
premia	n	p r ax - m i1 - ax
funk	n	f u1 N k
polí	n	p u - l i1
marcatge	n	m ax rr - k a1 d - Z ax
guerrista	n	g ax - rr i1 s - t ax
porcí	n	p u rr - s i1
texans	n	t ax k - s a1 n s
civisme	n	s i - B i1 z - m ax
correus	n	k u - rr E1 uw s
idear	n	i - D e - a1
veracitat	n	b ax - r ax - s i - t a1 t
tràiler	n	t r a1 - i - l ax rr
estupor	n	ax s - t u - p o1
desmesurada	n	d ax z - m ax - z u - r a1 - D ax
domèstiques	n	d u - m E1 s - t i - k ax s
dots	n	d O1 t s
màscares	n	m a1 s - k ax - r ax s
superació	n	s u - p ax - r ax - s i - o1
diana	n	d i - a1 - n ax
prematur	n	p r ax - m ax - t u1 rr
rampes	n	rr a1 m - p ax s
reposició	n	rr ax - p u - z i - s i - o1
culer	n	k u - l e1
diamants	n	d i - ax - m a1 n s
descampat	n	d ax s - k ax m - p a1 t
entrenat	n	ax n - t r ax - n a1 t
violador	n	b i - u - l ax - D o1
dialèctica	n	d i - ax - l E1 k - t i - k ax
interminable	n	i n - t ax rr - m i - n a1 b - b l ax
pòlisses	n	p O1 - l i - s ax s
emboscada	n	ax m - b u s - k a1 - D ax
ça	n	s a1
distracció	n	d i s - t r ax k - s i - o1
mics	n	m i1 k s
dossier	n	d u - s i - e1
octans	n	u k - t a1 n s
peruana	n	p ax - r u - a1 - n ax
harmonització	n	ax rr - m u - n i d - z ax - s i - o1
gendarmes	n	Z ax n - d a1 rr - m ax s
exploració	n	ax k s - p l u - r ax - s i - o1
empitjorar	n	ax m - p i d - Z u - r a1
avortar	n	ax - B u rr - t a1
clàssics	n	k l a1 - s i k s
espurna	n	ax s - p u1 rr - n ax
sahrauís	n	s ax - rr ax - w i1 s
subvencionar	n	s u b - b ax n - s i - u - n a1
investigats	n	i m - b ax s - t i - G a1 t s
barcelona	n	b ax rr - s ax - l o1 - n ax
govern	n	g u - B E1 rr n
espanya	n	ax s - p a1 - J ax
madrid	n	m ax - D r i1 t
catalunya	n	k ax - t ax - l u1 - J ax
generalitat	n	Z ax - n ax - r ax - l i - t a1 t
sant	n	s a1 n
josep	n	Z u - z E1 p
joan	n	Z u - a1 n
estat	n	ax s - t a1 t
barça	n	b a1 rr - s ax
europa	n	ax uw - r o1 - p ax
maría	n	m ax - r i1 - ax
	n	
josé	n	Z u - z e1
pp	n	p p
periodico	n	p E - r i - u - D i1 - k u
psoe	n	p s o1 - ax
ciu	n	s i1 uw
eua	n	E1 - w ax
eta	n	E1 - t ax
psc	n	p s k
pnb	n	p e - n ax - B e1
ue	n	w e1
york	n	y o1 rr k
efe	n	e1 - f ax
kosovo	n	k u - z o1 - B u
	n	
juan	n	Z u - a1 n
unió	n	u - n i - o1
jordi	n	Z O1 r - D i
nacional	n	n ax - s i - u - n a1 l
pujol	n	p u - Z O1 l
ajuntament	n	ax - Z u n - t ax - m e1 n
parlament	n	p ax rr - l ax - m e1 n
luis	n	l u1 j s
estats	n	ax s - t a1 t s
units	n	u - n i1 t s
europea	n	ax uw - r u - p E1 - ax
lleida	n	L e1 j - D ax
manuel	n	m ax - n u - E1 l
lliga	n	L i1 - G ax
frança	n	f r a1 n - s ax
consell	n	k u n - s E1 L
carlos	n	k a1 rr - l u s
tarragona	n	t ax - rr ax - G o1 - n ax
executiu	n	ax g - z ax - k u - t i1 uw
maria	n	m ax - r i1 - ax
guàrdia	n	g u - a1 r - D i - ax
garcía	n	g ax rr - s i1 - ax
ministeri	n	m i - n i s - t E1 - r i
javier	n	Z ax - B i - e1
tribunal	n	t r i - B u - n a1 l
congrés	n	k u N - g r e1 s
internet	n	i n - t ax rr - n E1 t
girona	n	Z i - r o1 - n ax
valència	n	b ax - l E1 n - s i - ax
els	n	ax l s
comissió	n	k u - m i - s i - o1
parís	n	p ax - r i1 s
partit	n	p ax rr - t i1 t
nova	n	n O1 - B ax
telefónica	n	t E - l ax - f o1 - n i - k ax
londres	n	l o1 n - d r e s
maragall	n	m ax - r ax - G a1 L
fernández	n	f ax rr - n a1 n - d ax s
gran	n	g r a1 n
civil	n	s i - B i1 l
miguel	n	m i - G E1 l
gonzález	n	g u n - z a1 - l ax s
alemanya	n	ax - l ax - m a1 - J ax
audiència	n	ax uw - D i - E1 n - s i - ax
copa	n	k o1 - p ax
santa	n	s a1 n - t ax
nou	n	n O1 uw
interior	n	i n - t ax - r i - o1 rr
angel	n	ax n - Z E1 l
carles	n	k a1 rr - l ax s
lluís	n	L u - i1 s
camp	n	k a1 m
universitat	n	u - n i - B ax rr - s i - t a1 t
exèrcit	n	ax g - z E1 rr - s i t
palau	n	p ax - l a1 uw
antoni	n	ax n - t O1 - n i
itàlia	n	i - t a1 - l i - ax
piqué	n	p i - k e1
	n	
administració	n	ax d - m i - n i s - t r ax - s i - o1
sevilla	n	s ax - B i1 - L ax
seguretat	n	s ax - G u - r ax - t a1 t
david	n	d ax - B i1 t
sabadell	n	s ax - B ax - D e1 L
gil	n	Z i1 l
institut	n	i n s - t i - t u1 t
mundial	n	m u n - d i - a1 l
xavier	n	S ax - B i - e1
rússia	n	rr u1 - s i - ax
pere	n	p e1 - r ax
canal	n	k ax - n a1 l
cambra	n	k a1 m - b r ax
onu	n	o1 - n u
san	n	s a1 n
suprem	n	s u - p r e1 m
clos	n	k l O1 s
general	n	Z ax - n ax - r a1 l
espanyol	n	ax s - p ax - J O1 l
justícia	n	Z u s - t i1 - s i - ax
reial	n	rr ax - y a1 l
nadal	n	n ax - D a1 l
hospital	n	u s - p i - t a1 l
popular	n	p u - p u - l a1 rr
euskadi	n	ax uw s - k a1 - D i
país	n	p ax - i1 s
mas	n	m a1 s
mar	n	m a1 rr
núñez	n	n u1 - J ax s
terrassa	n	t ax - rr a1 - s ax
rosa	n	rr O1 - z ax
teatre	n	t e - a1 - t r ax
sanitat	n	s ax - n i - t a1 t
bush	n	b u1 s
rivaldo	n	rr i - B a1 l - d u
enrique	n	ax n - rr i1 - k ax
social	n	s u - s i - a1 l
defensa	n	d ax - f E1 n - s ax
israel	n	i z - rr ax - E1 l
serra	n	s E1 - rr ax
vallès	n	b ax - L E1 s
economia	n	ax - k u - n u - m i1 - ax
hisenda	n	i - z e1 n - d ax
rafael	n	rr ax - f ax - E1 l
associació	n	ax - s u - s i - ax - s i - o1
banc	n	b a1 N
	n	
	n	
federació	n	f ax - D ax - r ax - s i - o1
jaume	n	Z a1 uw - m ax
caixa	n	k a1 - S ax
conselleria	n	k u n - s ax - L ax - r i1 - ax
rei	n	rr e1 j
pau	n	p a1 uw
treball	n	t r ax - B a1 L
cultura	n	k u l - t u1 - r ax
mallorca	n	m ax - L O1 rr - k ax
basc	n	b a1 s k
pla	n	p l a1
moscou	n	m u s - k O1 uw
alberto	n	ax l - B E1 rr - t u
francesc	n	f r ax n - s E1 s k
casa	n	k a1 - z ax
europeu	n	ax uw - r u - p E1 uw
atlètic	n	ax l - l E1 - t i k
tv	n	t e - B e1
constitució	n	k u n s - t i - t u - s i - o1
bilbao	n	b i l - B a1 - u
roma	n	rr o1 - m ax
marroc	n	m ax - rr O1 k
llobregat	n	L u - B r ax - G a1 t
can	n	k a1 n
senat	n	s ax - n a1 t
foment	n	f u - m e1 n
catalana	n	k ax - t ax - l a1 - n ax
díaz	n	d i1 - ax s
rato	n	rr a1 - t u
grup	n	g r u1 p
brussel·les	n	b r u - s E1 - l ax s
brasil	n	b r ax - z i1 l
centre	n	s e1 n - t r ax
andalusia	n	ax n - d ax - l u - z i1 - ax
sebastià	n	s ax - B ax s - t i - a1
policia	n	p u - l i - s i1 - ax
miquel	n	m i - k E1 l
martín	n	m ax rr - t i1 n
fundació	n	f u n - d ax - s i - o1
berlín	n	b ax rr - l i1 n
baix	n	b a1 S
medi	n	m E1 - D i
duran	n	d u - r a1 n
pasqual	n	p ax s - k w a1 l
mayor	n	m ax - y o1
xile	n	S i1 - l ax
nord	n	n O1 rr t
afers	n	ax - f e1 rr s
argentina	n	ax rr - Z ax n - t i1 - n ax
ferrer	n	f ax - rr e1
ambient	n	ax m - b i - e1 n
afganistan	n	ax v - G ax - n i s - t a1 n
costa	n	k O1 s - t ax
manresa	n	m ax n - rr E1 - z ax
junta	n	Z u1 n - t ax
oscar	n	u s - k a1
ebre	n	e1 - B r ax
jocs	n	Z O1 k s
agricultura	n	ax - G r i - k u l - t u1 - r ax
albert	n	ax l - B E1 rr t
liceu	n	l i - s E1 uw
mèxic	n	m E1 k - s i k
prat	n	p r a1 t
bretanya	n	b r ax - t a1 - J ax
ramon	n	rr ax - m o1 n
ana	n	a1 - n ax
iugoslàvia	n	y u - G u z - l a1 - B i - ax
belgrad	n	b ax l - G r a1 t
terra	n	t E1 - rr ax
central	n	s ax n - t r a1 l
exteriors	n	ax k s - t ax - r i - o1 rr s
aliança	n	ax - l i - a1 n - s ax
unit	n	u - n i1 t
guardiola	n	g w ax r - D i - O1 - l ax
església	n	ax z - G l e1 - z i - ax
regne	n	rr e1 g - n ax
holanda	n	u - l a1 n - d ax
déu	n	d e1 uw
raúl	n	rr ax - u1 l
carmen	n	k a1 rr - m ax n
salvador	n	s ax l - B ax - D o1
museu	n	m u - z E1 uw
jaime	n	Z a1 j - m ax
jutjat	n	Z u d - Z a1 t
jorge	n	Z O1 rr - Z ax
pilar	n	p i - l a1
mataró	n	m ax - t ax - r o1
navarro	n	n ax - B a1 - rr u
màlaga	n	m a1 - l ax - G ax
ciutat	n	s i uw - t a1 t
mossos	n	m o1 - s u s
blanca	n	b l a1 N - k ax
portugal	n	p u rr - t u - G a1 l
montserrat	n	m u n - s ax - rr a1 t
montjuïc	n	m o n - Z u - i1 k
puig	n	p u1 tS
borrell	n	b u - rr e1 L
república	n	rr ax - p u1 - B l i - k ax
sanz	n	s a1 n s
japó	n	Z ax - p o1
hospitalet	n	u s - p i - t ax - l E1 t
espanyola	n	ax s - p ax - J O1 - l ax
sala	n	s a1 - l ax
urbana	n	u r - B a1 - n ax
cuba	n	k u1 - B ax
reus	n	rr E1 uw s
iberia	n	i - B ax - r i1 - ax
ramón	n	rr ax - m o1 n
diputació	n	d i - p u - t ax - s i - o1
xina	n	S i1 - n ax
superior	n	s u - p ax - r i - o1 rr
ràdio	n	rr a1 - D i - u
festival	n	f ax s - t i - B a1 l
comerç	n	k u - m E1 rr s
andreu	n	ax n - d r e1 uw
campions	n	k ax m - p i - o1 n s
toledo	n	t u - l E1 - D u
joaquim	n	Z u - ax - k i1 m
gràcia	n	g r a1 - s i - ax
fira	n	f i1 - r ax
uefa	n	w e1 - f ax
víctor	n	b i1 k - t u
cristina	n	k r i s - t i1 - n ax
comitè	n	k u - m i - t E1
via	n	b i1 - ax
saragossa	n	s ax - r ax - G o1 - s ax
diagonal	n	d i - ax - G u - n a1 l
sergio	n	s ax rr - Z i1 - u
estrangers	n	ax s - t r ax n - Z e1 s
roberto	n	rr u - B E1 rr - t u
rodrigo	n	rr u - D r i1 - G u
anglaterra	n	ax N - g l ax - t E1 - rr ax
paco	n	p a1 - k u
antena	n	ax n - t E1 - n ax
isabel	n	i - z ax - B E1 l
amèrica	n	ax - m E1 - r i - k ax
ministres	n	m i - n i1 s - t r ax s
badalona	n	b ax - D ax - l o1 - n ax
ferran	n	f ax - rr a1 n
constitucional	n	k u n s - t i - t u - s i - u - n a1 l
marbella	n	m ax r - B e1 - L ax
fòrum	n	f O1 - r u m
martí	n	m ax rr - t i1
club	n	k l u1 p
trias	n	t r i1 - ax s
música	n	m u1 - z i - k ax
julio	n	Z u - l i1 - u
deportivo	n	d ax - p u rr - t i1 - B u
convergència	n	k u m - b ax rr - Z E1 n - s i - ax
societat	n	s u - s i - ax - t a1 t
indústria	n	i n - d u1 s - t r i - ax
emilio	n	ax - m i - l i1 - u
torres	n	t o1 - rr ax s
enric	n	ax n - rr i1 k
arenas	n	ax - r E1 - n ax s
santander	n	s a n - t ax n - d e1 rr
alfonso	n	ax l - f o1 n - s u
teresa	n	t ax - r E1 - z ax
vilanova	n	b i - l ax - n O1 - B ax
daniel	n	d ax - n i - E1 l
vitòria	n	b i - t O1 - r i - ax
putin	n	p u1 - t i n
austria	n	ax uw s - t r i1 - ax
bèlgica	n	b E1 l - Z i - k ax
mario	n	m ax - r i1 - u
irlanda	n	i rr - l a1 n - d ax
moncloa	n	m u N - k l o1 - ax
ibex	n	i - B E1 k s
balcans	n	b ax l - k a1 n s
rajoy	n	rr ax - Z O1 j
palma	n	p a1 l - m ax
vella	n	b e1 - L ax
mercat	n	m ax rr - k a1 t
alt	n	a1 l
africa	n	ax - f r i1 - k ax
castella	n	k ax s - t e1 - L ax
suïssa	n	s u - i1 - s ax
corts	n	k o1 rr s
alex	n	ax - l E1 k s
penal	n	p ax - n a1 l
educació	n	ax - D u - k ax - s i - o1
creu	n	k r E1 uw
català	n	k ax - t ax - l a1
auditori	n	ax uw - D i - t O1 - r i
política	n	p u - l i1 - t i - k ax
felip	n	f ax - l i1 p
artur	n	ax rr - t u1 rr
primera	n	p r i - m e1 - r ax
repsol	n	rr ax p - s O1 l
turquia	n	t u rr - k i1 - ax
pressupostos	n	p r ax - s u - p O1 s - t u s
municipal	n	m u - n i - s i - p a1 l
esquerra	n	ax s - k E1 - rr ax
tony	n	t o1 J
frank	n	f r a1 N k
sergi	n	s E1 rr - Z i
roja	n	rr O1 - Z ax
olímpic	n	u - l i1 m - p i k
melilla	n	m ax - l i1 - L ax
valladolid	n	b ax - L ax - D u - l i1 t
jerusalem	n	Z ax - r u - z ax - l E1 m
sydney	n	s i d - n E1 j
rambla	n	rr a1 m - b l ax
vall	n	b a1 L
villalonga	n	b i - L ax - l o1 N - g ax
valls	n	b a1 L s
forces	n	f O1 rr - s ax s
nacions	n	n ax - s i - o1 n s
esquadra	n	ax s - k w a1 - D r ax
unides	n	u - n i1 - D ax s
esteve	n	ax s - t e1 - B ax
agència	n	ax - Z E1 n - s i - ax
roger	n	rr u - Z e1
pacte	n	p a1 k - t ax
molina	n	m u - l i1 - n ax
paul	n	p a1 uw l
chaves	n	tS a1 - B ax s
feliu	n	f ax - l i1 uw
manchester	n	m ax N - tS ax s - t e1
mariano	n	m ax - r i - a1 - n u
mollet	n	m u - L E1 t
xarxa	n	S a1 rr - S ax
casas	n	k a1 - z ax s
aires	n	a1 j - r ax s
miami	n	m i - a1 - m i
jospin	n	Z O1 s - p i n
organització	n	u r - G ax - n i d - z ax - s i - o1
fiscalia	n	f i s - k ax - l i1 - ax
lleó	n	L ax - o1
vázquez	n	b a1 s - k ax s
lizarra	n	l i - z a1 - rr ax
endesa	n	ax n - d E1 - z ax
aragó	n	ax - r ax - G o1
galícia	n	g ax - l i1 - s i - ax
direcció	n	d i - r ax k - s i - o1
urgell	n	u rr - Z e1 L
quinze	n	k i1 n - z ax
anna	n	a1 n - n ax
roca	n	rr O1 - k ax
pib	n	p i1 p
pablo	n	p a1 b - b l u
coi	n	k O1 j
granollers	n	g r ax - n u - L e1 s
vila	n	b i1 - l ax
pakistan	n	p ax - k i s - t a1 n
chirac	n	tS i - r a1 k
macedònia	n	m ax - s ax - D O1 - n i - ax
andrés	n	ax n - d r e1 s
austràlia	n	ax uw s - t r a1 - l i - ax
carme	n	k a1 rr - m ax
ignacio	n	i g - n ax - s i1 - u
euskal	n	ax uw s - k a1 l
democràtica	n	d ax - m u - k r a1 - t i - k ax
balears	n	b ax - l e - a1 rr s
tortosa	n	t u rr - t o1 - z ax
bosque	n	b o1 s - k ax
món	n	m o1 n
alonso	n	ax - l o1 n - s u
múrcia	n	m u1 rr - s i - ax
papa	n	p a1 - p ax
setmana	n	s ax m - m a1 - n ax
xavi	n	S a1 - B i
salut	n	s ax - l u1 t
navarra	n	n ax - B a1 - rr ax
segona	n	s ax - G o1 - n ax
iñaki	n	i - J a1 - k i
cruz	n	k r u1 s
núria	n	n u1 - r i - ax
bàsic	n	b a1 - z i k
andorra	n	ax n - d o1 - rr ax
ensenyament	n	ax n - s ax - J ax - m e1 n
marta	n	m a1 rr - t ax
diego	n	d i - E1 - G u
toni	n	t O1 - n i
cugat	n	k u - G a1 t
rexach	n	rr ax k - s a1 k
borsa	n	b o1 rr - s ax
sants	n	s a1 n s
ceuta	n	s E1 uw - t ax
colòmbia	n	k u - l O1 m - b i - ax
solana	n	s u - l a1 - n ax
augusto	n	ax uw - G u1 s - t u
reis	n	rr e1 j s
adrià	n	ax - D r i - a1
valles	n	b a1 - L ax s
orient	n	u - r i - e1 n
bernabéu	n	b ax rr - n ax - B e1 uw
servei	n	s ax r - B E1 j
bòsnia	n	b O1 z - n i - ax
figueres	n	f i - G e1 - r ax s
efe	n	e1 - f ax
almeria	n	ax l - m ax - r i1 - ax
ipc	n	i - p e - s e1
martin	n	m a1 rr - t i n
penedès	n	p ax - n ax - D E1 s
cruyff	n	k r u1 j f
unida	n	u - n i1 - D ax
turisme	n	t u - r i1 z - m ax
bono	n	b o1 - n u
sèrbia	n	s E1 r - B i - ax
estatut	n	ax s - t ax - t u1 t
milà	n	m i - l a1
eduard	n	ax - D u - a1 rr t
coloma	n	k u - l o1 - m ax
soler	n	s u - l e1
molins	n	m u - l i1 n s
diputats	n	d i - p u - t a1 t s
jones	n	Z o1 - n ax s
louis	n	l O1 - w i s
assemblea	n	ax - s ax m - b l e1 - ax
departament	n	d ax - p ax rr - t ax - m e1 n
celta	n	s E1 l - t ax
baltasar	n	b ax l - t ax - z a1
sitges	n	s i1 d - Z ax s
arxiu	n	ax rr - S i1 uw
ronda	n	rr o1 n - d ax
gas	n	g a1 s
romero	n	rr u - m e1 - r u
besòs	n	b ax - z O1 s
fraga	n	f r a1 - G ax
armades	n	ax rr - m a1 - D ax s
gibraltar	n	Z i - B r ax l - t a1
lucas	n	l u1 - k ax s
france	n	f r a - N E1
presidència	n	p r ax - z i - D E1 n - s i - ax
tom	n	t o1 m
don	n	d O1 n
iglesias	n	i - G l ax - z i1 - ax s
or	n	O1 rr
empordà	n	ax m - p u r - D a1
vendrell	n	b ax n - d r e1 L
públiques	n	p u1 - B l i - k ax s
txetxènia	n	tS ax t - S E1 - n i - ax
guipúscoa	n	g i - p u1 s - k u - ax
real	n	rr e - a1 l
dia	n	d i1 - ax
cúper	n	k u1 - p ax
florida	n	f l u - r i1 - D ax
césar	n	s e1 - z ax
col·legi	n	k u - l E1 - Z i
grècia	n	g r E1 - s i - ax
muñoz	n	m u - J o1 s
xabier	n	S ax - B i - e1
comarcal	n	k u - m ax rr - k a1 l
seu	n	s e1 uw
llibre	n	L i1 - B r ax
eixample	n	ax - S a1 m - p l ax
astúries	n	ax s - t u1 - r i - ax s
socialista	n	s u - s i - ax - l i1 s - t ax
iniciativa	n	i - n i - s i - ax - t i1 - B ax
rubí	n	rr u - B i1
del	n	d ax l
vilafranca	n	b i - l ax - f r a1 N - k ax
port	n	p O1 rr t
pep	n	p E1 p
escola	n	ax s - k O1 - l ax
mercè	n	m ax rr - s E1
viena	n	b i - E1 - n ax
ernest	n	ax rr - n e1 s t
iraq	n	i - r a1 k
huguet	n	u - G E1 t
digital	n	d i - Z i - t a1 l
alfredo	n	ax l - f r E1 - D u
televisió	n	t ax - l ax - B i - z i - o1
miró	n	m i - r o1
otegi	n	u - t E1 - Z i
judicial	n	Z u - D i - s i - a1 l
vic	n	b i1 k
cadis	n	k a1 - D i s
guerra	n	g E1 - rr ax
maresme	n	m ax - r E1 z - m ax
lliure	n	L i1 uw - r ax
fra	n	f r a1
vaticà	n	b ax - t i - k a1
sol	n	s O1 l
marina	n	m ax - r i1 - n ax
montoro	n	m o - n O1 - r u
suècia	n	s u - E1 - s i - ax
españa	n	ax s - p a1 - J ax
federal	n	f ax - D ax - r a1 l
trànsit	n	t r a1 n - s i t
olot	n	u - l O1 t
julia	n	Z u - l i1 - ax
dani	n	d a1 - n i
gabriel	n	g ax - B r i - E1 l
cap	n	k a1 p
hierro	n	y E1 - rr u
oriental	n	u - r i - ax n - t a1 l
olímpics	n	u - l i1 m - p i k s
peña	n	p E1 - J ax
batasuna	n	b ax - t ax - z u1 - n ax
vidal	n	b i - D a1 l
lazio	n	l ax - z i1 - u
oviedo	n	u - B i - E1 - D u
havana	n	ax - B a1 - n ax
dret	n	d r E1 t
lisboa	n	l i z - B o1 - ax
poble	n	p O1 b - b l ax
elián	n	ax - l i - a1 n
canadà	n	k ax - n ax - D a1
esports	n	ax s - p O1 rr s
samaranch	n	s ax - m ax - r a1 N
premi	n	p r E1 - m i
biscaia	n	b i s - k a1 - y ax
confederació	n	k u m - f ax - D ax - r ax - s i - o1
gerard	n	Z ax - r a1 rr t
marc	n	m a1 rr k
bayern	n	b ax - y E1 rr n
cornellà	n	k u rr - n ax - L a1
occidental	n	u k - s i - D ax n - t a1 l
nobel	n	n u - B E1 l
però	n	p ax - r O1
albània	n	ax l - B a1 - n i - ax
hotel	n	u - t E1 l
eurocopa	n	E uw - r u - k o1 - p ax
domingo	n	d u - m i1 N - g u
canàries	n	k ax - n a1 - r i - ax s
berlusconi	n	b ax rr - l u s - k O1 - n i
corretja	n	k u - rr E1 d - Z ax
granada	n	g r ax - n a1 - D ax
occident	n	u k - s i - D e1 n
ribó	n	rr i - B o1
finances	n	f i - n a1 n - s ax s
extremadura	n	E k s - t r ax - m ax - D u1 - r ax
almodóvar	n	ax l - m u - D o1 - B ax
india	n	i n - d i1 - ax
ignasi	n	i g - n a1 - z i
hebron	n	ax - B r o1 n
goya	n	g O1 - y ax
caja	n	k a1 - Z ax
matutes	n	m ax - t u1 - t ax s
fifa	n	f i1 - f ax
alacant	n	ax - l ax - k a1 n
laura	n	l a1 uw - r ax
manel	n	m ax - n E1 l
iván	n	i - B a1 n
urbanisme	n	u r - B ax - n i1 z - m ax
gaza	n	g a1 - z ax
macias	n	m ax - s i1 - ax s
drets	n	d r E1 t s
michel	n	m i - tS E1 l
cristóbal	n	k r i s - t o1 - B ax l
delegació	n	d ax - l ax - G ax - s i - o1
mercedes	n	m ax rr - s E1 - D ax s
igualada	n	i - G w ax - l a1 - D ax
poder	n	p u - D E1
vladímir	n	b l ax - D i1 - m i
barajas	n	b ax - r a1 - Z ax s
any	n	a1 J
est	n	e1 s t
saura	n	s a1 uw - r ax
castells	n	k ax s - t e1 L s
arias	n	ax - r i1 - ax s
autoritat	n	ax uw - t u - r i - t a1 t
pimentel	n	p i - m ax n - t E1 l
gabinet	n	g ax - B i - n E1 t
seat	n	s e - a1 t
opa	n	O1 - p ax
sud	n	s u1 t
pons	n	p O1 n s
raval	n	rr ax - B a1 l
fidel	n	f i - D E1 l
pequín	n	p ax - k i1 n
oriol	n	u - r i - O1 l
comunitat	n	k u - m u - n i - t a1 t
pamplona	n	p ax m - p l O1 - n ax
orquestra	n	u rr - k e1 s - t r ax
pristina	n	p r i s - t i1 - n ax
mediterrani	n	m ax - D i - t ax - rr a1 - n i
pròxim	n	p r O1 k - s i m
aíto	n	ax - i1 - t u
divisió	n	d i - B i - z i - o1
banesto	n	b ax - n e1 s - t u
perú	n	p ax - r u1
marín	n	m ax - r i1 n
transports	n	t r ax n s - p O1 rr s
rivera	n	rr i - B e1 - r ax
salamanca	n	s ax - l ax - m a1 N - k ax
territorial	n	t ax - rr i - t u - r i - a1 l
disney	n	d i z - n E1 j
ortega	n	u rr - t E1 - G ax
llatinoamèrica	n	L ax - t i - n u - ax - m E1 - r i - k ax
ginebra	n	Z i - n e1 - B r ax
iva	n	i1 - B ax
betis	n	b E1 - t i s
conferència	n	k u m - f ax - r E1 n - s i - ax
veïns	n	b ax - i1 n s
gaudí	n	g ax uw - D i1
iran	n	i - r a1 n
angels	n	ax n - Z E1 l s
selva	n	s E1 l - B ax
ricard	n	rr i - k a1 rr t
futbol	n	f u b - b O1 l
munic	n	m u - n i1 k
teatro	n	t e - a1 - t r u
natural	n	n ax - t u - r a1 l
rovira	n	rr u - B i1 - r ax
alliberament	n	ax - L i - B ax - r ax - m e1 n
carreras	n	k ax - rr e1 - r ax s
eva	n	e1 - B ax
palestina	n	p ax - l ax s - t i1 - n ax
instrucció	n	i n s - t r u k - s i - o1
veneçuela	n	b ax - n ax - s u - E1 - l ax
codi	n	k O1 - D i
bank	n	b a1 N k
castillo	n	k ax s - t i1 - L u
fons	n	f o1 n s
art	n	a1 rr t
grandes	n	g r a1 n - d ax s
cervera	n	s ax r - B e1 - r ax
vera	n	b e1 - r ax
major	n	m ax - Z o1
press	n	p r e1 s
calderón	n	k ax l - d ax - r o1 n
tributària	n	t r i - B u - t a1 - r i - ax
història	n	i s - t O1 - r i - ax
lluch	n	L u1 k
nicolás	n	n i - k u - l a1 s
carta	n	k a1 rr - t ax
castelló	n	k ax s - t ax - L o1
cine	n	s i1 - n ax
cocu	n	k O1 - k u
abel	n	ax - B E1 l
sofia	n	s u - f i1 - ax
zona	n	z o1 - n ax
ramírez	n	rr ax - m i1 - r ax s
agustín	n	ax - G u s - t i1 n
amsterdam	n	ax m s - t ax r - D a1 m
vía	n	b i1 - ax
milan	n	m i - l a1 n
príncep	n	p r i1 n - s ax p
socials	n	s u - s i - a1 l s
arnau	n	ax rr - n a1 uw
pepe	n	p e1 - p ax
martorell	n	m ax rr - t u - r e1 L
comas	n	k o1 - m ax s
manxa	n	m a1 n - S ax
salou	n	s ax - l O1 uw
jo	n	Z O1
park	n	p a1 rr k
califòrnia	n	k ax - l i - f O1 rr - n i - ax
reina	n	rr e1 j - n ax
elena	n	ax - l E1 - n ax
arts	n	a1 rr s
moyà	n	m u - y a1
alta	n	a1 l - t ax
grec	n	g r e1 k
croàcia	n	k r u - a1 - s i - ax
porto	n	p O1 rr - t u
riera	n	rr i - e1 - r ax
font	n	f O1 n
castellers	n	k ax s - t ax - L e1 s
corunya	n	k u - rr u1 - J ax
informació	n	i m - f u rr - m ax - s i - o1
rabat	n	rr ax - B a1 t
acebes	n	ax - s e1 - B ax s
ulster	n	u l s - t e1
abelardo	n	ax - B ax - l a1 r - D u
pública	n	p u1 - B l i - k ax
cortés	n	k u rr - t e1 s
conde	n	k o1 n - d ax
ribera	n	rr i - B e1 - r ax
sainz	n	s a1 j n s
arsenal	n	ax rr - s ax - n a1 l
bonet	n	b u - n E1 t
corea	n	k u - r e1 - ax
trillo	n	t r i1 - L u
saviola	n	s ax - B i - O1 - l ax
bosch	n	b O1 s k
burgos	n	b u1 r - G u s
ibarra	n	i - B a1 - rr ax
pallerols	n	p ax - L ax - r O1 l s
rius	n	rr i1 uw s
silva	n	s i1 l - B ax
suárez	n	s u - a1 - r ax s
verds	n	b E1 rr s
carod-rovira	n	k ax - r o d - rr u - B i1 - r ax
liga	n	l i1 - G ax
asia	n	ax - z i1 - ax
ferrero	n	f ax - rr e1 - r u
lasa	n	l a1 - z ax
noruega	n	n u - r u - E1 - G ax
alabès	n	ax - l ax - B E1 s
poblenou	n	p u b - b l ax - n O1 uw
parc	n	p a1 rr k
anton	n	ax n - t o1 n
athletic	n	ax t - l ax - t i1 k
vega	n	b E1 - G ax
golf	n	g O1 l f
cannes	n	k a1 n - n ax s
adolfo	n	ax - D o1 l - f u
ona	n	o1 - n ax
agustí	n	ax - G u s - t i1
grau	n	g r a1 uw
pentàgon	n	p ax n - t a1 - G u n
oficina	n	u - f i - s i1 - n ax
egipte	n	ax - Z i1 p - t ax
berga	n	b e1 r - G ax
autònoma	n	ax uw - t O1 - n u - m ax
cultural	n	k u l - t u - r a1 l
competència	n	k u m - p ax - t E1 n - s i - ax
cerdanyola	n	s ax r - D ax - J O1 - l ax
aena	n	ax - E1 - n ax
clínic	n	k l i1 - n i k
estudis	n	ax s - t u1 - D i s
kabul	n	k ax - B u1 l
bassat	n	b ax - s a1 t
atlàntica	n	ax l - l a1 n - t i - k ax
serrat	n	s ax - rr a1 t
national	n	n ax - t i - u - n a1 l
vigo	n	b i1 - G u
american	n	ax - m ax - r i - k a1 n
transport	n	t r ax n s - p O1 rr t
texas	n	t e1 k - s ax s
unitat	n	u - n i - t a1 t
borís	n	b u - r i1 s
claudio	n	k l ax uw - D i1 - u
tibidabo	n	t i - B i - D a1 - B u
ronaldo	n	rr u - n a1 l - d u
sarrià	n	s ax - rr i - a1
ser	n	s e1
dalí	n	d ax - l i1
morientes	n	m u - r i - e1 n - t ax s
plataforma	n	p l ax - t ax - f o1 rr - m ax
margarita	n	m ax r - G ax - r i1 - t ax
crivillé	n	k r i - B i - L e1
rocío	n	rr u - s i1 - u
tractat	n	t r ax k - t a1 t
palacios	n	p ax - l ax - s i1 - u s
morales	n	m u - r a1 - l ax s
méndez	n	m e1 n - d ax s
família	n	f ax - m i1 - l i - ax
ciències	n	s i - E1 n - s i - ax s
vicenç	n	b i - s E1 n s
torre	n	t o1 - rr ax
cambrils	n	k ax m - b r i1 l s
mari	n	m a1 - r i
mora	n	m O1 - r ax
dinamarca	n	d i - n ax - m a1 rr - k ax
serveis	n	s ax r - B E1 j s
aquest	n	ax - k E1 t
lagos	n	l a1 - G u s
segura	n	s ax - G u1 - r ax
bages	n	b a1 - Z ax s
saló	n	s ax - l o1
chávez	n	tS a1 - B ax s
universal	n	u - n i - B ax rr - s a1 l
narcís	n	n ax rr - s i1 s
inter	n	i1 n - t ax rr
governació	n	g u - B ax rr - n ax - s i - o1
villar	n	b i - L a1
cano	n	k a1 - n u
obres	n	O1 - B r ax s
picasso	n	p i - k a1 - s u
aquesta	n	ax - k E1 s - t ax
pirineu	n	p i - r i - n E1 uw
bogarde	n	b u - G a1 r - D ax
tamudo	n	t ax - m u1 - D u
polònia	n	p u - l O1 - n i - ax
republicana	n	rr ax - p u - B l i - k a1 - n ax
guillermo	n	g i - L E1 rr - m u
franca	n	f r a1 N - k ax
zabala	n	z ax - B a1 - l ax
joventut	n	Z u - B ax n - t u1 t
montenegro	n	m o - n ax - n e1 - G r u
líban	n	l i1 - B ax n
joseba	n	Z u - z e1 - B ax
antic	n	ax n - t i1 k
manolo	n	m ax - n O1 - l u
colom	n	k u - l o1 m
acció	n	ax k - s i - o1
acadèmia	n	ax - k ax - D E1 - m i - ax
aràbia	n	ax - r a1 - B i - ax
pol	n	p O1 l
balaguer	n	b ax - l ax - G e1
horta	n	O1 rr - t ax
cercle	n	s e1 rr - k l ax
ríos	n	rr i1 - u s
tòquio	n	t O1 - k i - u
associacions	n	ax - s u - s i - ax - s i - o1 n s
barris	n	b a1 - rr i s
héctor	n	e1 k - t u
oriental	n	u - r i - ax n - t a1 l
cisjordània	n	s i - Z u r - D a1 - n i - ax
tenerife	n	t ax - n ax - r i1 - f ax
montilla	n	m o - n i1 - L ax
iberdrola	n	i - B ax r - D r O1 - l ax
còrdova	n	k O1 r - D u - B ax
león	n	l ax - o1 n
carolina	n	k ax - r u - l i1 - n ax
rojo	n	rr O1 - Z u
zaplana	n	z ax - p l a1 - n ax
academia	n	ax - k ax - D ax - m i1 - ax
amnistia	n	ax m - n i s - t i1 - ax
montcada	n	m o N - k a1 - D ax
olímpica	n	u - l i1 m - p i - k ax
castelldefels	n	k ax s - t ax L - d ax - f E1 l s
benestar	n	b e - n ax s - t a1
mònaco	n	m O1 - n a - k o
llatina	n	L ax - t i1 - n ax
ciència	n	s i - E1 n - s i - ax
síria	n	s i1 - r i - ax
corte	n	k O1 rr - t ax
borbó	n	b u r - B o1
champions	n	tS ax m - p i - o1 n s
villalobos	n	b i - L ax - l o1 - B u s
reyes	n	rr E1 - y ax s
tercer	n	t ax rr - s e1
alvaro	n	ax l - B a1 - r u
grozni	n	g r O1 z - n i
occidental	n	u k - s i - D ax n - t a1 l
palmas	n	p a1 l - m ax s
gasol	n	g ax - z O1 l
luna	n	l u1 - n ax
premià	n	p r ax - m i - a1
