abatre	n	ax - B a1 - t r ax
abdomen	n	ax b - d o1 - m ax n
abductor	n	ax b - d u k - t o1
abecedari	n	ax - B ax - s ax - D a1 - r i
aberració	n	ax - B ax - rr ax - s i - o1
abillats	n	ax - B i - L a1 t s
abnegats	n	ax b - n ax - G a1 t s
abocaments	n	ax - B u - k ax - m e1 n s
abolir	n	ax - B u - l i1
abonada	n	ax - B u - n a1 - D ax
abonarà	n	ax - B u - n ax - r a1
abonava	n	ax - B u - n a1 - B ax
abraona	n	ax - B r ax - o1 - n ax
abraonarà	n	ax - B r ax - u - n ax - r a1
abrasat	n	ax - B r ax - z a1 t
abreujada	n	ax - B r ax uw - Z a1 - D ax
abrigat	n	ax - B r i - G a1 t
absort	n	ax p - s O1 rr t
abstenir	n	ax p s - t ax - n i1
abstrets	n	ax p s - t r e1 t s
absurditat	n	ax p - s u r - D i - t a1 t
acabessim	n	ax - k ax - B ax - s i1 m
academicista	n	ax - k ax - D ax - m i - s i1 s - t ax
acaricia	n	ax - k ax - r i - s i1 - ax
acariciant	n	ax - k ax - r i - s i - a1 n
acariciava	n	ax - k ax - r i - s i - a1 - B ax
acarona	n	ax - k ax - r o1 - n ax
acaronant	n	ax - k ax - r u - n a1 n
acaronar	n	ax - k ax - r u - n a1
acaronat	n	ax - k ax - r u - n a1 t
accelera	n	ax k - s ax - l e1 - r ax
accelerat	n	ax k - s ax - l ax - r a1 t
accessibilitat	n	ax k - s ax - s i - B i - l i - t a1 t
accessoris	n	ax k - s ax - s O1 - r i s
acidesa	n	ax - s i - D E1 - z ax
aclariment	n	ax - k l ax - r i - m e1 n
acollidora	n	ax - k u - L i - D o1 - r ax
acollidor	n	ax - k u - L i - D o1
acolorit	n	ax - k u - l u - r i1 t
acomiadament	n	ax - k u - m i - ax - D ax - m e1 n
acomiadar	n	ax - k u - m i - ax - D a1
acomiadaríem	n	ax - k u - m i - ax - D ax - r i1 - ax m
acomiadat	n	ax - k u - m i - ax - D a1 t
acomiadem	n	ax - k u - m i - ax - D E1 m
acomodador	n	ax - k u - m u - D ax - D o1
acomodament	n	ax - k u - m u - D ax - m e1 n
acreditatius	n	ax - k r ax - D i - t ax - t i1 uw s
acta	n	a1 k - t ax
actitudinals	n	ax k - t i - t u - D i - n a1 l s
activació	n	ax k - t i - B ax - s i - o1
activar	n	ax k - t i - B a1
activat	n	ax k - t i - B a1 t
activistes	n	ax k - t i - B i1 s - t ax s
actriu	n	ax k - t r i1 uw
actualitza	n	ax k - t u - ax - l i1 d - z ax
actualitzacions	n	ax k - t u - ax - l i d - z ax - s i - o1 n s
actualitzador	n	ax k - t u - ax - l i d - z ax - D o1
actualitzar	n	ax k - t u - ax - l i d - z a1
actualitzem	n	ax k - t u - ax - l i d - z E1 m
actualment	n	ax k - t u - a l - m e1 n
acuradament	n	ax - k u - r a - D ax - m e1 n
acústic	n	ax - k u1 s - t i k
adàgio	n	a - D a1 - Z i - o
adaptador	n	ax - D ax p - t ax - D o1
addiccions	n	ax d - d i k - s i - o1 n s
addicional	n	ax d - d i - s i - u - n a1 l
adell	n	ax - D e1 L
adena	n	ax - D E1 - n ax
adequa	n	ax - D e1 - k w ax
adequar	n	ax - D ax - k w a1
adherits	n	ax - D ax - r i1 t s
adinerats	n	ax - D i - n ax - r a1 t s
adjudica	n	ax d - Z u - D i1 - k ax
adjuntar	n	ax d - Z u n - t a1
adjunteu	n	ax d - Z u n - t E1 uw
administrador	n	ax d - m i - n i s - t r ax - D o1
admiració	n	ax d - m i - r ax - s i - o1
admiradors	n	ax d - m i - r ax - D o1 s
adobar	n	ax - D u - B a1
adoració	n	ax - D u - r ax - s i - o1
adornats	n	ax - D u rr - n a1 t s
adornen	n	ax - D o1 rr - n ax n
adorns	n	ax - D o1 rr n s
adrià	n	ax - D r i - a1
adrianenc	n	ax - D r i - ax - n E1 N
adrianenques	n	ax - D r i - ax - n E1 N - k ax s
adscrit	n	ax ts - k r i1 t
advertències	n	ax d - b ax rr - t E1 n - s i - ax s
advoquem	n	ax d - b u - k E1 m
aeròdroms	n	ax - e - r O1 - D r u m s
aeronàutics	n	ax - e - r u - n a1 - u - t i k s
aeroportuari	n	ax - e - r u - p u rr - t u - a1 - r i
afartar	n	ax - f ax rr - t a1
afeblit	n	ax - f ax b - b l i1 t
afectacions	n	ax - f ax k - t ax - s i - o1 n s
afeitar	n	ax - f ax j - t a1
aferrada	n	ax - f ax - rr a1 - D ax
aferrat	n	ax - f ax - rr a1 t
aferrava	n	ax - f ax - rr a1 - B ax
afgà	n	ax v - G a1
afganistan	n	ax v - G ax - n i s - t a1 n
afició	n	ax - f i - s i - o1
aficionat	n	ax - f i - s i - u - n a1 t
aficionats	n	ax - f i - s i - u - n a1 t s
afinar	n	ax - f i - n a1
afores	n	ax - f O1 - r ax s
afortunada	n	ax - f u rr - t u - n a1 - D ax
Àfrica	n	a1 - f r i - k ax
africà	n	ax - f r i - k a1
africana	n	ax - f r i - k a1 - n ax
africans	n	ax - f r i - k a1 n s
afruitat	n	ax - f r u j - t a1 t
afuselladament	n	ax - f u - z ax - L a - D ax - m e1 n
agència	n	ax - Z E1 n - s i - ax
agenda	n	ax - Z e1 n - d ax
agilitar	n	ax - Z i - l i - t a1
agilitzar	n	ax - Z i - l i d - z a1
àgils	n	a1 - Z i l s
agonia	n	ax - G u - n i1 - ax
agraeix	n	ax - G r ax - E1 S
agraeixo	n	ax - G r ax - E1 - S u
agraïda	n	ax - G r ax - i1 - D ax
agrair	n	ax - G r ax - i1
agraïts	n	ax - G r ax - i1 t s
agre	n	a1 - G r ax
agressors	n	ax - G r ax - s o1 s
aguaitar	n	ax - G w ax j - t a1
aguait	n	ax - G w a1 j t
aguditzats	n	ax - G u - D i d - z a1 t s
àguila	n	a1 - G i - l ax
agustí	n	ax - G u s - t i1
aida	n	a1 j - D ax
aiguaforts	n	a j - G w ax - f O1 rr s
aigualida	n	ax j - G w ax - l i1 - D ax
aigualís	n	ax j - G w ax - l i1 s
aiguaviva	n	a j - G w ax - B i1 - B ax
aimara	n	ax j - m a1 - r ax
airosament	n	ax j - r o - z ax - m e1 n
aixafar	n	ax - S ax - f a1
aixafem	n	ax - S ax - f E1 m
aixeta	n	ax - S E1 - t ax
aixoplugat	n	ax - S u - p l u - G a1 t
ajusta	n	ax - Z u1 s - t ax
ajustar	n	ax - Z u s - t a1
ajusti	n	ax - Z u1 s - t i
alapont	n	ax - l ax - p o1 n
alarma	n	ax - l a1 rr - m ax
alauita	n	ax - l ax - w i1 - t ax
alba	n	a1 l - B ax
albacete	n	ax l - B ax - s e1 - t ax
albacetenyes	n	ax l - B ax - s ax - t E1 - J ax s
albània	n	ax l - B a1 - n i - ax
albera	n	ax l - B e1 - r ax
alberga	n	ax l - B E1 r - G ax
albergava	n	ax l - B ax r - G a1 - B ax
albergínia	n	ax l - B ax rr - Z i1 - n i - ax
alberguen	n	ax l - B E1 r - G ax n
albirar	n	ax l - B i - r a1
albons	n	ax l - B o1 n s
àlbums	n	a1 l - B u m s
alcover	n	ax l - k u - B e1
aldo	n	a1 l - d u
aleatoris	n	ax - l e - ax - t O1 - r i s
alegrar	n	ax - l ax - G r a1
alegre	n	ax - l e1 - G r ax
alejandro	n	ax - l ax - Z a1 n - d r u
alella	n	ax - l e1 - L ax
alenada	n	ax - l ax - n a1 - D ax
alertes	n	ax - l E1 rr - t ax s
Àlex	n	a1 - l ax k s
alfabètic	n	ax l - f ax - B E1 - t i k
alfred	n	ax l - f r E1 t
alga	n	a1 l - G ax
algèria	n	ax l - Z E1 - r i - ax
àlgic	n	a1 l - Z i k
algún	n	ax l - G u1 n
alienats	n	ax - l i - ax - n a1 t s
àlies	n	a1 - l i - ax s
alineació	n	ax - l i - n e - ax - s i - o1
alinear	n	ax - l i - n e - a1
allau	n	ax - L a1 uw
allaus	n	ax - L a1 uw s
all	n	a1 L
al·legació	n	ax - l ax - G ax - s i - o1
al·legant	n	ax - l ax - G a1 n
al·lèrgia	n	ax - l E1 rr - Z i - ax
al·lèrgies	n	ax - l E1 rr - Z i - ax s
alletin	n	ax - L e1 - t i n
alleujada	n	ax - L ax uw - Z a1 - D ax
alliberadors	n	ax - L i - B ax - r ax - D o1 s
allistar	n	ax - L i s - t a1
allotgen	n	ax - L O1 d - Z ax n
allotja	n	ax - L O1 d - Z ax
allotjar	n	ax - L u d - Z a1
allotjaven	n	ax - L u d - Z a1 - B ax n
al·lucinants	n	ax - l u - s i - n a1 n s
al·lucinat	n	ax - l u - s i - n a1 t
almívar	n	ax l - m i1 - B ax rr
almoina	n	ax l - m O1 j - n ax
alps	n	a1 l p s
alternativament	n	ax l - t ax rr - n ax - t i - B ax - m e1 n
altímetre	n	ax l - t i1 - m ax - t r ax
alumna	n	ax - l u1 m - n ax
Álvarez	n	a1 l - B ax - r ax s
amabilitat	n	ax - m ax - B i - l i - t a1 t
amable	n	ax - m a1 b - b l ax
amagatall	n	ax - m ax - G ax - t a1 L
amán	n	ax - m a1 n
amanida	n	ax - m ax - n i1 - D ax
amanides	n	ax - m ax - n i1 - D ax s
amanyagués	n	ax - m ax - J ax - G e1 s
amarat	n	ax - m ax - r a1 t
amargament	n	ax - m a r - G ax - m e1 n
amargant	n	ax - m ax r - G a1 n
amarronat	n	ax - m ax - rr u - n a1 t
ambaixada	n	ax m - b ax - S a1 - D ax
ambientadors	n	ax m - b i - ax n - t ax - D o1 s
ambigua	n	ax m - b i1 - G w ax
ametlles	n	ax - m E1 L - L ax s
amigdalitis	n	ax - m i g - d ax - l i1 - t i s
amistosament	n	ax - m i s - t o - z ax - m e1 n
amoïnis	n	ax - m u - i1 - n i s
ampi	n	a1 m - p i
amplificat	n	ax m - p l i - f i - k a1 t
ampolleta	n	ax m - p u - L E1 - t ax
amsterdam	n	ax m s - t ax r - D a1 m
amuntegaven	n	ax - m u n - t ax - G a1 - B ax n
analitzador	n	ax - n ax - l i d - z ax - D o1
anarquista	n	ax - n ax rr - k i1 s - t ax
ancestral	n	ax n - s ax s - t r a1 l
andorra	n	ax n - d o1 - rr ax
andrea	n	ax n - d r E1 - ax
andreu	n	ax n - d r e1 uw
anècdota	n	ax - n E1 g - d u - t ax
anècdotes	n	ax - n E1 g - d u - t ax s
anelles	n	ax - n e1 - L ax s
anemòmetre	n	ax - n ax - m O1 - m ax - t r ax
angèlica	n	ax n - Z E1 - l i - k ax
anglaterra	n	ax N - g l ax - t E1 - rr ax
anglesola	n	ax N - g l ax - z O1 - l ax
anglòfona	n	ax N - g l O1 - f u - n ax
anglosaxons	n	a N - g l u - s ax k - s o1 n s
angoixosos	n	ax N - g u - S o1 - z u s
anguiles	n	ax N - g i1 - l ax s
animació	n	ax - n i - m ax - s i - o1
animada	n	ax - n i - m a1 - D ax
animalons	n	ax - n i - m ax - l o1 n s
aniversari	n	ax - n i - B ax rr - s a1 - r i
anna	n	a1 n - n ax
anne	n	a1 n - n ax
annexa	n	ax n - n e1 k - s ax
anoia	n	ax - n O1 - y ax
anorac	n	ax - n u - r a1 k
anorèxia	n	ax - n u - r E1 k - s i - ax
anorèxica	n	ax - n u - r E1 k - s i - k ax
anotació	n	ax - n u - t ax - s i - o1
anques	n	a1 N - k ax s
ànsia	n	a1 n - s i - ax
ànsies	n	a1 n - s i - ax s
antagonista	n	ax n - t ax - G u - n i1 s - t ax
anterioritat	n	ax n - t ax - r i - u - r i - t a1 t
anteriorment	n	ax n - t ax - r i - o rr - m e1 n
antiboira	n	a n - t i - B O1 j - r ax
antídot	n	ax n - t i1 - D u t
antidroga	n	a n - t i - D r O1 - G ax
antinatural	n	a n - t i - n ax - t u - r a1 l
antiquari	n	ax n - t i - k w a1 - r i
antiquaris	n	ax n - t i - k w a1 - r i s
antirobatori	n	a n - t i - rr u - B ax - t O1 - r i
antisida	n	a n - t i - s i1 - D ax
antoni	n	ax n - t O1 - n i
antonímia	n	ax n - t u - n i1 - m i - ax
antonomàsia	n	ax n - t u - n u - m a1 - z i - ax
antròpiques	n	ax n - t r O1 - p i - k ax s
antropòlegs	n	ax n - t r u - p O1 - l ax k s
antropologia	n	ax n - t r u - p u - l u - Z i1 - ax
anualment	n	ax - n u - a l - m e1 n
anxoves	n	ax n - S O1 - B ax s
apache	n	ax - p a1 - tS ax
apallissar	n	ax - p ax - L i - s a1
aparicio	n	ax - p ax - r i - s i1 - u
apart	n	ax - p a1 rr t
apartheid	n	ax - p ax rr - t E1 j t
apassionada	n	ax - p ax - s i - u - n a1 - D ax
apassionadament	n	ax - p ax - s i - u - n a - D ax - m e1 n
àpat	n	a1 - p ax t
àpats	n	a1 - p ax t s
apendre	n	ax - p E1 n - d r ax
aperitiu	n	ax - p ax - r i - t i1 uw
aplaudien	n	ax - p l ax uw - D i1 - ax n
aplaudiment	n	ax - p l ax uw - D i - m e1 n
aplaudiments	n	ax - p l ax uw - D i - m e1 n s
aplaudint	n	ax - p l ax uw - D i1 n
apreciables	n	ax - p r ax - s i - a1 b - b l ax s
apretar	n	ax - p r ax - t a1
aproximadament	n	ax - p r u k - s i - m a - D ax - m e1 n
apte	n	a1 p - t ax
apunts	n	ax - p u1 n s
apurant	n	ax - p u - r a1 n
apurar	n	ax - p u - r a1
aquàtiques	n	ax - k u - a1 - t i - k ax s
aqüífer	n	ax - k w i1 - f ax rr
aràbia	n	ax - r a1 - B i - ax
aragó	n	ax - r ax - G o1
arameu	n	ax - r ax - m E1 uw
aran	n	ax - r a1 n
aranès	n	ax - r ax - n E1 s
aranya	n	ax - r a1 - J ax
àrbitre	n	a1 r - B i - t r ax
arboç	n	ax r - B o1 s
arenga	n	ax - r E1 N - g ax
arenys	n	ax - r E1 J s
argelaga	n	ax rr - Z ax - l a1 - G ax
argots	n	ax r - G O1 t s
argumentant	n	ax r - G u - m ax n - t a1 n
argumentar	n	ax r - G u - m ax n - t a1
argumentativa	n	ax r - G u - m ax n - t ax - t i1 - B ax
argumentaven	n	ax r - G u - m ax n - t a1 - B ax n
arias	n	ax - r i1 - ax s
aristocràtic	n	ax - r i s - t u - k r a1 - t i k
armadura	n	ax rr - m ax - D u1 - r ax
armadures	n	ax rr - m ax - D u1 - r ax s
armariets	n	ax rr - m ax - r i - E1 t s
arnau	n	ax rr - n a1 uw
aroma	n	ax - r o1 - m ax
aromàtiques	n	ax - r u - m a1 - t i - k ax s
aromes	n	ax - r o1 - m ax s
arquímedes	n	ax rr - k i1 - m ax - D ax s
arquitectes	n	ax rr - k i - t E1 k - t ax s
arquitectura	n	ax rr - k i - t ax k - t u1 - r ax
arrabassar	n	ax - rr ax - B ax - s a1
arracono	n	ax - rr ax - k o1 - n u
arran	n	ax - rr a1 n
arrasada	n	ax - rr ax - z a1 - D ax
arraulida	n	ax - rr ax uw - l i1 - D ax
arrauxada	n	ax - rr ax uw - S a1 - D ax
arrebossada	n	ax - rr ax - B u - s a1 - D ax
arrebossar	n	ax - rr ax - B u - s a1
arrepenjada	n	ax - rr ax - p ax n - Z a1 - D ax
arrestat	n	ax - rr ax s - t a1 t
arriessiu	n	ax - rr i - ax - s i1 uw
arriet	n	ax - rr i - E1 t
arrissat	n	ax - rr i - s a1 t
arrissats	n	ax - rr i - s a1 t s
arrodoneixen	n	ax - rr u - D u - n E1 - S ax n
arromangar	n	ax - rr u - m ax N - g a1
arronsa	n	ax - rr o1 n - s ax
arronsat	n	ax - rr u n - s a1 t
arronsava	n	ax - rr u n - s a1 - B ax
arrossegament	n	ax - rr u - s ax - G ax - m e1 n
arrugada	n	ax - rr u - G a1 - D ax
arrugats	n	ax - rr u - G a1 t s
arruïnada	n	ax - rr u - i - n a1 - D ax
arruinats	n	ax - rr u j - n a1 t s
arruïnats	n	ax - rr u - i - n a1 t s
artefactes	n	ax rr - t ax - f a1 k - t ax s
artèria	n	ax rr - t E1 - r i - ax
artesà	n	ax rr - t ax - z a1
Àrtic	n	a1 rr - t i k
artificiositat	n	ax rr - t i - f i - s i - u - z i - t a1 t
artilleria	n	ax rr - t i - L ax - r i1 - ax
arturet	n	ax rr - t u - r E1 t
arxiu	n	ax rr - S i1 uw
arxiven	n	ax rr - S i1 - B ax n
ascensor	n	ax - s ax n - s o1
ase	n	a1 - z ax
asfalt	n	ax s - f a1 l t
asfixiant	n	ax s - f i k - s i - a1 n
asiàtics	n	ax - z i - a1 - t i k s
asiàtiques	n	ax - z i - a1 - t i - k ax s
asimètrica	n	ax - s i - m E1 - t r i - k ax
asímptotes	n	ax - s i1 m - t u - t ax s
aspirants	n	ax s - p i - r a1 n s
aspirina	n	ax s - p i - r i1 - n ax
aspra	n	a1 s - p r ax
aspres	n	a1 s - p r ax s
assabentat	n	ax - s ax - B ax n - t a1 t
assaborida	n	ax - s ax - B u - r i1 - D ax
assaborir	n	ax - s ax - B u - r i1
assemblea	n	ax - s ax m - b l e1 - ax
assentada	n	ax - s ax n - t a1 - D ax
assenteix	n	ax - s ax n - t E1 S
assenteixo	n	ax - s ax n - t E1 - S u
assentir	n	ax - s ax n - t i1
assequibles	n	ax - s ax - k i1 b - b l ax s
assessorament	n	ax - s ax - s u - r ax - m e1 n
assessors	n	ax - s ax - s o1 s
assetjava	n	ax - s ax d - Z a1 - B ax
assídua	n	ax - s i1 - D u - ax
assignació	n	ax - s i g - n ax - s i - o1
assímptotes	n	ax - s i1 m - t u - t ax s
assistenta	n	ax - s i s - t e1 n - t ax
asteques	n	ax s - t E1 - k ax s
asterisc	n	ax s - t ax - r i1 s k
astigmatisme	n	ax s - t i g - m ax - t i1 z - m ax
astre	n	a1 s - t r ax
astres	n	a1 s - t r ax s
astrologia	n	ax s - t r u - l u - Z i1 - ax
astrònom	n	ax s - t r O1 - n u m
astronomia	n	ax s - t r u - n u - m i1 - ax
astronòmica	n	ax s - t r u - n O1 - m i - k ax
atabala	n	ax - t ax - B a1 - l ax
atabalar	n	ax - t ax - B ax - l a1
atabalat	n	ax - t ax - B ax - l a1 t
atansar	n	ax - t ax n - s a1
atapeïts	n	ax - t ax - p ax - i1 t s
ataronjades	n	ax - t ax - r u n - Z a1 - D ax s
atemptat	n	ax - t ax m - t a1 t
atenes	n	ax - t E1 - n ax s
atentament	n	ax - t e n - t ax - m e1 n
aterrar	n	ax - t ax - rr a1
aterratge	n	ax - t ax - rr a1 d - Z ax
àtic	n	a1 - t i k
atocha	n	ax - t O1 - tS ax
àtoms	n	a1 - t u m s
atònita	n	ax - t O1 - n i - t ax
atracar	n	ax - t r ax - k a1
atrinxeren	n	ax - t r i n - S e1 - r ax n
atrotinada	n	ax - t r u - t i - n a1 - D ax
atrotinat	n	ax - t r u - t i - n a1 t
atxes	n	a1 t - S ax s
atzabeja	n	ax d - z ax - B E1 - Z ax
atzagaiada	n	ax d - z ax - G ax - y a1 - D ax
audiència	n	ax uw - D i - E1 n - s i - ax
àudio	n	a1 - u - D i - o
audiovisual	n	ax uw - D i - u - B i - z u - a1 l
audiovisuals	n	ax uw - D i - u - B i - z u - a1 l s
auge	n	a1 uw - Z ax
august	n	ax uw - G u1 s t
aula	n	a1 uw - l ax
aureli	n	ax uw - r E1 - l i
aurèola	n	ax uw - r E1 - u - l ax
auró	n	ax uw - r o1
aus	n	a1 uw s
austràlia	n	ax uw s - t r a1 - l i - ax
australiana	n	ax uw s - t r ax - l i - a1 - n ax
australopitecs	n	ax uw s - t r ax - l u - p i - t E1 k s
Àustria	n	a1 - u s - t r i - ax
autenticació	n	ax uw - t ax n - t i - k ax - s i - o1
autoacceptació	n	a uw - t u - ax k - s ax p - t ax - s i - o1
autoavaluació	n	a uw - t u - ax - B ax - l u - ax - s i - o1
autobús	n	ax uw - t u - B u1 s
autobusos	n	ax uw - t u - B u1 - z u s
autocar	n	ax uw - t u - k a1 rr
autoescola	n	a uw - t u - ax s - k O1 - l ax
autoestima	n	a uw - t u - ax s - t i1 - m ax
autògraf	n	ax uw - t O1 - G r ax f
automàtica	n	ax uw - t u - m a1 - t i - k ax
automàticament	n	ax uw - t u - m a - t i - k ax - m e1 n
automàtic	n	ax uw - t u - m a1 - t i k
autòmats	n	ax uw - t O1 - m ax t s
autopista	n	ax uw - t u - p i1 s - t ax
autopistes	n	ax uw - t u - p i1 s - t ax s
autora	n	ax uw - t o1 - r ax
autoregalar	n	a uw - t u - rr ax - G ax - l a1
autoservei	n	a uw - t u - s ax r - B E1 j
autòtrofa	n	ax uw - t O1 - t r u - f ax
auxili	n	ax uw k - s i1 - l i
auxilis	n	ax uw k - s i1 - l i s
avaluables	n	ax - B ax - l u - a1 b - b l ax s
avaluació	n	ax - B ax - l u - ax - s i - o1
avaluatiu	n	ax - B ax - l u - ax - t i1 uw
avanç	n	ax - B a1 n s
avantguarda	n	ax - B ax N - g w a1 r - D ax
avantpassats	n	ax - B a m - p ax - s a1 t s
avantprojecte	n	ax - B a m - p r u - Z e1 k - t ax
avaria	n	ax - B ax - r i1 - ax
ave	n	a1 - B ax
avenir	n	ax - B ax - n i1
avergonyeix	n	ax - B ax r - G u - J E1 S
avergonyia	n	ax - B ax r - G u - J i1 - ax
avergonyida	n	ax - B ax r - G u - J i1 - D ax
avergonyit	n	ax - B ax r - G u - J i1 t
avet	n	ax - B E1 t
àvidament	n	a - B i - D ax - m e1 n
Àvila	n	a1 - B i - l ax
avinguda	n	ax - B i N - g u1 - D ax
avingudes	n	ax - B i N - g u1 - D ax s
avís	n	ax - B i1 s
avorriment	n	ax - B u - rr i - m e1 n
avorriments	n	ax - B u - rr i - m e1 n s
babau	n	b ax - B a1 uw
bable	n	b a1 - B l ax
bacteriològica	n	b ax k - t ax - r i - u - l O1 - Z i - k ax
badajoz	n	b ax - D ax - Z o1 s
badallant	n	b ax - D ax - L a1 n
badalli	n	b ax - D a1 - L i
badalls	n	b ax - D a1 L s
badalona	n	b ax - D ax - l o1 - n ax
badia	n	b ax - D i1 - ax
bàdminton	n	b a1 d - m i n - t u n
bages	n	b a1 - Z ax s
bagul	n	b ax - G u1 l
baguls	n	b ax - G u1 l s
baixista	n	b ax - S i1 s - t ax
bajanada	n	b ax - Z ax - n a1 - D ax
balaguer	n	b ax - l ax - G e1
balbucejant	n	b ax l - B u - s ax - Z a1 n
balcànic	n	b ax l - k a1 - n i k
balconada	n	b ax l - k u - n a1 - D ax
balconet	n	b ax l - k u - n E1 t
balder	n	b ax l - d e1
balenes	n	b ax - l E1 - n ax s
ballador	n	b ax - L ax - D o1
ballaruques	n	b ax - L ax - r u1 - k ax s
ballet	n	b ax - L E1 t
bambes	n	b a1 m - b ax s
banals	n	b ax - n a1 l s
banca	n	b a1 N - k ax
bancària	n	b ax N - k a1 - r i - ax
bancari	n	b ax N - k a1 - r i
bancàries	n	b ax N - k a1 - r i - ax s
bàndols	n	b a1 n - d u l s
bangkok	n	b ax N - k o1 k
banotti	n	b ax - n O1 - t i
banyera	n	b ax - J e1 - r ax
banyista	n	b ax - J i1 s - t ax
banyoles	n	b ax - J O1 - l ax s
banyuls	n	b ax - J u1 l s
baralla	n	b ax - r a1 - L ax
barallar	n	b ax - r ax - L a1
baralleu	n	b ax - r ax - L E1 uw
barallo	n	b ax - r a1 - L u
barat	n	b ax - r a1 t
barates	n	b ax - r a1 - t ax s
barats	n	b ax - r a1 t s
barbàrie	n	b ax r - B a1 - r i - ax
barberà	n	b ax r - B ax - r a1
barber	n	b ax r - B e1
barbs	n	b a1 rr p s
barça	n	b a1 rr - s ax
barcelona	n	b ax rr - s ax - l o1 - n ax
barcino	n	b ax rr - s i1 - n u
bardagí	n	b ax r - D ax - Z i1
barral	n	b ax - rr a1 l
barrals	n	b ax - rr a1 l s
barranc	n	b ax - rr a1 N
barranquisme	n	b ax - rr ax N - k i1 z - m ax
barraquer	n	b ax - rr ax - k e1
barrina	n	b ax - rr i1 - n ax
barrufets	n	b ax - rr u - f E1 t s
basament	n	b ax - z ax - m e1 n
bàsicament	n	b a - z i - k ax - m e1 n
bastard	n	b ax s - t a1 rr t
bategaven	n	b ax - t ax - G a1 - B ax n
bateria	n	b ax - t ax - r i1 - ax
bateries	n	b ax - t ax - r i1 - ax s
batxillerat	n	b ax t - S i - L ax - r a1 t
batzegada	n	b ax d - z ax - G a1 - D ax
bava	n	b a1 - B ax
bavejava	n	b ax - B ax - Z a1 - B ax
beatificació	n	b e - ax - t i - f i - k ax - s i - o1
beatífic	n	b e - ax - t i1 - f i k
be	n	b e1
bebè	n	b ax - B E1
beca	n	b E1 - k ax
belga	n	b E1 l - G ax
bèlgica	n	b E1 l - Z i - k ax
belgrad	n	b ax l - G r a1 t
belgues	n	b E1 l - G ax s
bellaterra	n	b e - L ax - t E1 - rr ax
bellver	n	b e L - B e1 rr
beneeix	n	b ax - n ax - E1 S
beneficia	n	b ax - n ax - f i - s i1 - ax
beneficiari	n	b ax - n ax - f i - s i - a1 - r i
beneficiosa	n	b ax - n ax - f i - s i - o1 - z ax
beneita	n	b ax - n E1 j - t ax
beneplàcit	n	b e - n ax - p l a1 - s i t
benestant	n	b e - n ax s - t a1 n
benestar	n	b e - n ax s - t a1
benèvol	n	b ax - n E1 - B u l
benidorm	n	b e - n i - D o1 rr m
bentòniques	n	b ax n - t O1 - n i - k ax s
benvinguda	n	b e m - b i N - g u1 - D ax
benvingut	n	b e m - b i N - g u1 t
benvinguts	n	b e m - b i N - g u1 t s
beques	n	b E1 - k ax s
berber	n	b ax r - B e1
berenar	n	b ax - r ax - n a1
berenen	n	b ax - r E1 - n ax n
berga	n	b e1 r - G ax
berguedà	n	b ax r - G ax - D a1
berna	n	b E1 rr - n ax
berta	n	b E1 rr - t ax
berzeliïta	n	b ax rr - z ax - l i - i1 - t ax
besalú	n	b ax - z ax - l u1
besàvia	n	b ax - z a1 - B i - ax
besavi	n	b ax - z a1 - B i
besòs	n	b ax - z O1 s
bessones	n	b ax - s o1 - n ax s
beuratge	n	b ax uw - r a1 d - Z ax
biberons	n	b i - B ax - r o1 n s
bibliòfils	n	b i - B l i - O1 - f i l s
bibliotecària	n	b i - B l i - u - t ax - k a1 - r i - ax
bibliotecari	n	b i - B l i - u - t ax - k a1 - r i
bibliotecaris	n	b i - B l i - u - t ax - k a1 - r i s
bici	n	b i1 - s i
bicicleta	n	b i - s i - k l E1 - t ax
bicicletes	n	b i - s i - k l E1 - t ax s
bicis	n	b i1 - s i s
bielorrusia	n	b i - ax - l u - rr u - z i1 - ax
biennal	n	b i - ax n - n a1 l
bilions	n	b i - l i - o1 n s
binaris	n	b i - n a1 - r i s
biogeografia	n	b i - u - Z ax - u - G r ax - f i1 - ax
biògraf	n	b i - O1 - G r ax f
biologia	n	b i - u - l u - Z i1 - ax
biològicament	n	b i - u - l O - Z i - k ax - m e1 n
bipedisme	n	b i - p ax - D i1 z - m ax
bisbal	n	b i z - B a1 l
biscaia	n	b i s - k a1 - y ax
bistecs	n	b i s - t E1 k s
bivalves	n	b i - B a1 l - B ax s
blair	n	b l ax - i1
blanes	n	b l a1 - n ax s
blavós	n	b l ax - B o1 s
blocaires	n	b l u - k a1 j - r ax s
blocar	n	b l u - k a1
bloquejada	n	b l u - k ax - Z a1 - D ax
bloquen	n	b l O1 - k ax n
boada	n	b u - a1 - D ax
bocabadat	n	b o - k ax - B ax - D a1 t
bocaterrosa	n	b o - k ax - t ax - rr o1 - z ax
bodegues	n	b u - D E1 - G ax s
bodes	n	b o1 - D ax s
bogatell	n	b u - G ax - t e1 L
bogeria	n	b u - Z ax - r i1 - ax
bohèmia	n	b u - E1 - m i - ax
bohemi	n	b u - E1 - m i
bohemis	n	b u - E1 - m i s
bohigas	n	b u - i1 - G ax s
boi	n	b O1 j
boies	n	b O1 - y ax s
boirina	n	b u j - r i1 - n ax
boirum	n	b u j - r u1 m
boixedes	n	b u - S E1 - D ax s
boixos	n	b o1 - S u s
bol	n	b O1 l
boleà	n	b u - l e - a1
boletes	n	b u - l E1 - t ax s
bolets	n	b u - l E1 t s
bolígraf	n	b u - l i1 - G r ax f
bolígrafs	n	b u - l i1 - G r ax f s
boll	n	b o1 L
bolonyesa	n	b u - l u - J E1 - z ax
bolquen	n	b o1 l - k ax n
bolxevic	n	b u l - S ax - B i1 k
bombarders	n	b u m - b ax r - D e1 s
bombers	n	b u m - b e1 s
bombolleta	n	b u m - b u - L E1 - t ax
bombones	n	b u m - b o1 - n ax s
bombons	n	b u m - b o1 n s
bonhomia	n	b u - n u - m i1 - ax
bonificacions	n	b u - n i - f i - k ax - s i - o1 n s
borda	n	b o1 r - D ax
borden	n	b o1 r - D ax n
bordeus	n	b u r - D E1 uw s
borges	n	b O1 rr - Z ax s
borni	n	b O1 rr - n i
borrosa	n	b u - rr o1 - z ax
borsa	n	b o1 rr - s ax
bosquet	n	b u s - k E1 t
botella	n	b u - t e1 - L ax
botes	n	b o1 - t ax s
botifarra	n	b u - t i - f a1 - rr ax
botifarretes	n	b u - t i - f ax - rr E1 - t ax s
botzines	n	b u d - z i1 - n ax s
bou	n	b O1 uw
braçalets	n	b r ax - s ax - l E1 t s
brama	n	b r a1 - m ax
brasa	n	b r a1 - z ax
brases	n	b r a1 - z ax s
brasil	n	b r ax - z i1 l
brasília	n	b r ax - z i1 - l i - ax
bratislava	n	b r ax - t i z - l a1 - B ax
brau	n	b r a1 uw
brava	n	b r a1 - B ax
bravates	n	b r ax - B a1 - t ax s
bressolat	n	b r ax - s u - l a1 t
bretanya	n	b r ax - t a1 - J ax
bretolades	n	b r ax - t u - l a1 - D ax s
breument	n	b r e uw - m e1 n
brevetat	n	b r ax - B ax - t a1 t
brian	n	b r i - a1 n
brillantor	n	b r i - L ax n - t o1
brindar	n	b r i n - d a1
brindàrem	n	b r i n - d a1 - r ax m
brindis	n	b r i1 n - d i s
brioixos	n	b r i - O1 - S u s
brisa	n	b r i1 - z ax
brises	n	b r i1 - z ax s
brogit	n	b r u - Z i1 t
brogits	n	b r u - Z i1 t s
brollen	n	b r o1 - L ax n
bromejant	n	b r u - m ax - Z a1 n
bromur	n	b r u - m u1 rr
bronca	n	b r o1 N - k ax
bruixa	n	b r u1 - S ax
bruixes	n	b r u1 - S ax s
brussel·les	n	b r u - s E1 - l ax s
brutalment	n	b r u - t a l - m e1 n
brutícia	n	b r u - t i1 - s i - ax
bucarest	n	b u - k ax - r e1 s t
budapest	n	b u - D ax - p e1 s t
buenos	n	b u - E1 - n u s
bufet	n	b u - f E1 t
bufons	n	b u - f o1 n s
buidor	n	b u j - D o1
buldòzer	n	b u l - d O1 - z ax
bulgària	n	b u l - G a1 - r i - ax
bullent	n	b u - L e1 n
bullit	n	b u - L i1 t
bumerang	n	b u - m ax - r a1 N
bunyols	n	b u - J O1 l s
burgos	n	b u1 r - G u s
burla	n	b u1 rr - l ax
burleta	n	b u rr - l E1 - t ax
burros	n	b u1 - rr u s
burxeu	n	b u rr - S E1 uw
bus	n	b u1 s
bush	n	b u1 s
bústia	n	b u1 s - t i - ax
bústies	n	b u1 s - t i - ax s
butlletí	n	b u L - L ax - t i1
cabanyes	n	k ax - B a1 - J ax s
cabellera	n	k ax - B ax - L e1 - r ax
caben	n	k a1 - B ax n
cabíem	n	k ax - B i1 - ax m
cabien	n	k ax - B i1 - ax n
cabina	n	k ax - B i1 - n ax
cabirons	n	k ax - B i - r o1 n s
cables	n	k a1 b - b l ax s
cabo	n	k a1 - B u
cabòries	n	k ax - B O1 - r i - ax s
cabre	n	k a1 - B r ax
cabró	n	k ax - B r o1
caçadores	n	k ax - s ax - D o1 - r ax s
caçador	n	k ax - s ax - D o1
cacau	n	k ax - k a1 uw
cacen	n	k a1 - s ax n
cacera	n	k ax - s e1 - r ax
cadàver	n	k ax - D a1 - B ax rr
cadàvers	n	k ax - D a1 - B ax rr s
cadells	n	k ax - D e1 L s
cadenat	n	k ax - D ax - n a1 t
cadeneta	n	k ax - D ax - n E1 - t ax
cadernera	n	k ax - D ax rr - n e1 - r ax
cadiretes	n	k ax - D i - r E1 - t ax s
cadis	n	k a1 - D i s
caducades	n	k ax - D u - k a1 - D ax s
caducitat	n	k ax - D u - s i - t a1 t
cafeteria	n	k ax - f ax - t ax - r i1 - ax
cagar	n	k ax - G a1
cagat	n	k ax - G a1 t
cago	n	k a1 - G u
caixer	n	k ax - S e1
caixeta	n	k ax - S E1 - t ax
ca	n	k a1
calàbria	n	k ax - l a1 - B r i - ax
calaixera	n	k ax - l ax - S e1 - r ax
calamarsa	n	k ax - l ax - m a1 rr - s ax
calavera	n	k ax - l ax - B e1 - r ax
calba	n	k a1 l - B ax
calb	n	k a1 l p
calçada	n	k ax l - s a1 - D ax
calçoina	n	k ax l - s O1 j - n ax
calçons	n	k ax l - s o1 n s
calculadora	n	k ax l - k u - l ax - D o1 - r ax
calders	n	k ax l - d e1 s
caldo	n	k a1 l - d u
calefacció	n	k ax - l ax - f ax k - s i - o1
calella	n	k ax - l e1 - L ax
calendari	n	k ax - l ax n - d a1 - r i
calentons	n	k ax - l ax n - t o1 n s
caleta	n	k ax - l E1 - t ax
calibre	n	k ax - l i1 - B r ax
càlides	n	k a1 - l i - D ax s
càlids	n	k a1 - l i t s
califòrnia	n	k ax - l i - f O1 rr - n i - ax
calories	n	k ax - l u - r i1 - ax s
calze	n	k a1 l - z ax
camafeu	n	k ax - m ax - f E1 uw
camarón	n	k a - m ax - rr o1 n
cambotja	n	k ax m - b O1 d - Z ax
cambrer	n	k ax m - b r e1
cambrils	n	k ax m - b r i1 l s
càmera	n	k a1 - m ax - r ax
camerí	n	k ax - m ax - r i1
camisetes	n	k ax - m i - z E1 - t ax s
campaneta	n	k ax m - p ax - n E1 - t ax
campanetes	n	k ax m - p ax - n E1 - t ax s
càmping	n	k a1 m - p i N
campió	n	k ax m - p i - o1
campionat	n	k ax m - p i - u - n a1 t
campus	n	k a1 m - p u s
camuflada	n	k ax - m u - f l a1 - D ax
canadà	n	k ax - n ax - D a1
canalització	n	k ax - n ax - l i d - z ax - s i - o1
canalitza	n	k ax - n ax - l i1 d - z ax
canalla	n	k ax - n a1 - L ax
canàries	n	k ax - n a1 - r i - ax s
canari	n	k ax - n a1 - r i
canberra	n	k ax m - b E1 - rr ax
cancel·la	n	k ax n - s E1 - l ax
cancel·lar	n	k ax n - s ax - l a1
cançoner	n	k ax n - s u - n e1
cancún	n	k ax N - k u1 n
candaus	n	k ax n - d a1 uw s
candidat	n	k ax n - d i - D a1 t
candidats	n	k ax n - d i - D a1 t s
candi	n	k a1 n - d i
cangur	n	k ax N - g u1 rr
caniques	n	k ax - n i1 - k ax s
canonada	n	k ax - n u - n a1 - D ax
canonades	n	k ax - n u - n a1 - D ax s
cànon	n	k a1 - n u n
cantàbria	n	k ax n - t a1 - B r i - ax
cantimplora	n	k ax n - t i m - p l O1 - r ax
canviador	n	k ax m - b i - ax - D o1
canyissos	n	k ax - J i1 - s u s
canyòning	n	k ax - J O1 - n i N
caoba	n	k ax - O1 - B ax
caos	n	k a1 - o s
caòtica	n	k ax - O1 - t i - k ax
capbussar	n	k ax b - b u - s a1
capcinada	n	k ax p - s i - n a1 - D ax
capgirat	n	k a b - Z i - r a1 t
capgròs	n	k a b - g r O1 s
capgrossos	n	k a b - g r O1 - s u s
capmàs	n	k ax b - m a1 s
caporal	n	k ax - p u - r a1 l
capritxós	n	k ax - p r i t - S o1 s
captivadora	n	k ax p - t i - B ax - D o1 - r ax
captiva	n	k ax p - t i1 - B ax
captivat	n	k ax p - t i - B a1 t
captura	n	k ax p - t u1 - r ax
capuccinos	n	k ax - p u k - s i1 - n u s
caputxeta	n	k ax - p u t - S E1 - t ax
caracas	n	k ax - r a1 - k ax s
caravana	n	k ax - r ax - B a1 - n ax
carbassons	n	k ax r - B ax - s o1 n s
carboncles	n	k ax r - B o1 N - k l ax s
carboni	n	k ax r - B O1 - n i
cardenal	n	k ax r - D ax - n a1 l
cardener	n	k ax r - D ax - n e1
cards	n	k a1 rr s
carència	n	k ax - r E1 n - s i - ax
cargola	n	k ax r - G O1 - l ax
cargol	n	k ax r - G O1 l
cargols	n	k ax r - G O1 l s
caribenya	n	k ax - r i - B E1 - J ax
caricaturistes	n	k ax - r i - k ax - t u - r i1 s - t ax s
carícia	n	k ax - r i1 - s i - ax
carinyo	n	k ax - r i1 - J u
carinyosos	n	k ax - r i - J o1 - z u s
caritatives	n	k ax - r i - t ax - t i1 - B ax s
carla	n	k a1 rr - l ax
carles	n	k a1 rr - l ax s
carlo	n	k a1 rr - l u
carlos	n	k a1 rr - l u s
carlota	n	k ax rr - l O1 - t ax
carme	n	k a1 rr - m ax
carnero	n	k ax rr - n e1 - r u
carnestoltes	n	k ax rr - n ax s - t O1 l - t ax s
carnet	n	k ax rr - n E1 t
carnisseries	n	k ax rr - n i - s ax - r i1 - ax s
carnívores	n	k ax rr - n i1 - B u - r ax s
carnívor	n	k ax rr - n i1 - B u rr
caroline	n	k ax - r u - l i1 - n ax
carpa	n	k a1 rr - p ax
carpàtxio	n	k ax rr - p a1 t - S i - u
carpes	n	k a1 rr - p ax s
carpeta	n	k ax rr - p E1 - t ax
carpetes	n	k ax rr - p E1 - t ax s
carreras	n	k ax - rr e1 - r ax s
carreró	n	k ax - rr ax - r o1
carril	n	k ax - rr i1 l
carrosseria	n	k ax - rr u - s ax - r i1 - ax
carruatge	n	k ax - rr u - a1 d - Z ax
carruatges	n	k ax - rr u - a1 d - Z ax s
cartaginesos	n	k ax rr - t ax - Z i - n E1 - z u s
cartago	n	k a rr - t a1 - G o
cartellera	n	k ax rr - t ax - L e1 - r ax
cartera	n	k ax rr - t e1 - r ax
cartografia	n	k ax rr - t u - G r ax - f i1 - ax
cartogràfica	n	k ax rr - t u - G r a1 - f i - k ax
cartró	n	k ax rr - t r o1
cartrons	n	k ax rr - t r o1 n s
carxofes	n	k ax rr - S O1 - f ax s
casajuana	n	k a - z ax - Z u - a1 - n ax
casal	n	k ax - z a1 l
casals	n	k ax - z a1 l s
casament	n	k ax - z ax - m e1 n
cascada	n	k ax s - k a1 - D ax
casella	n	k ax - z e1 - L ax
caselles	n	k ax - z e1 - L ax s
casolana	n	k ax - z u - l a1 - n ax
casota	n	k ax - z O1 - t ax
castanyada	n	k ax s - t ax - J a1 - D ax
castanya	n	k ax s - t a1 - J ax
castanys	n	k ax s - t a1 J s
castella	n	k ax s - t e1 - L ax
castellers	n	k ax s - t ax - L e1 s
castellterçol	n	k ax s - t ax L - t ax rr - s O1 l
casualitat	n	k ax - z u - ax - l i - t a1 t
catàleg	n	k ax - t a1 - l ax k
catalunya	n	k ax - t ax - l u1 - J ax
catàstrofe	n	k ax - t a1 s - t r u - f ax
catastrofista	n	k ax - t ax s - t r u - f i1 s - t ax
caterina	n	k ax - t ax - r i1 - n ax
catolicisme	n	k ax - t u - l i - s i1 z - m ax
caucasians	n	k ax uw - k ax - z i - a1 n s
causants	n	k ax uw - z a1 n s
cavalcaven	n	k ax - B ax l - k a1 - B ax n
cavalleria	n	k ax - B ax - L ax - r i1 - ax
cavallers	n	k ax - B ax - L e1 s
ceba	n	s E1 - B ax
ceip	n	s E1 j p
cel·la	n	s E1 - l ax
celler	n	s ax - L e1
cel·les	n	s E1 - l ax s
cel·lulitis	n	s ax - l u - l i1 - t i s
celobert	n	s E - l u - B E1 rr t
celoni	n	s ax - l O1 - n i
celo	n	s E1 - l u
cendrer	n	s ax n - d r e1
cendrers	n	s ax n - d r e1 s
centelleig	n	s ax n - t ax - L E1 tS
centenàries	n	s ax n - t ax - n a1 - r i - ax s
centígrads	n	s ax n - t i1 - G r ax t s
centilitres	n	s ax n - t i - l i1 - t r ax s
ceptre	n	s e1 p - t r ax
ceràmiques	n	s ax - r a1 - m i - k ax s
cera	n	s E1 - r ax
cercador	n	s ax rr - k ax - D o1
cercadors	n	s ax rr - k ax - D o1 s
cerdanya	n	s ax r - D a1 - J ax
cerdanyola	n	s ax r - D ax - J O1 - l ax
certesa	n	s ax rr - t E1 - z ax
certificat	n	s ax rr - t i - f i - k a1 t
certificats	n	s ax rr - t i - f i - k a1 t s
cervera	n	s ax r - B e1 - r ax
cervesa	n	s ax r - B E1 - z ax
ceuta	n	s E1 uw - t ax
cheng	n	tS E1 N
chicago	n	tS i - k a1 - G o
chirac	n	tS i - r a1 k
cibeles	n	s i - B E1 - l ax s
cicatritzants	n	s i - k ax - t r i d - z a1 n s
cicatritzar	n	s i - k ax - t r i d - z a1
cigarreta	n	s i - G ax - rr E1 - t ax
cinèfils	n	s i - n E1 - f i l s
cinematogràfic	n	s i - n ax - m ax - t u - G r a1 - f i k
cinglera	n	s i N - g l e1 - r ax
cínic	n	s i1 - n i k
cinturó	n	s i n - t u - r o1
circuit	n	s i rr - k u1 j t
circulars	n	s i rr - k u - l a1 s
circumferència	n	s i rr - k u m - f ax - r E1 n - s i - ax
cireres	n	s i - r e1 - r ax s
cir	n	s i1 rr
cisallament	n	s i - z a - L ax - m e1 n
cisellada	n	s i - z ax - L a1 - D ax
cítrics	n	s i1 - t r i k s
ciurana	n	s i uw - r a1 - n ax
ciutadana	n	s i uw - t ax - D a1 - n ax
ciutadanes	n	s i uw - t ax - D a1 - n ax s
ciutadania	n	s i uw - t ax - D ax - n i1 - ax
cívic	n	s i1 - B i k
cívics	n	s i1 - B i k s
civisme	n	s i - B i1 z - m ax
clapes	n	k l a1 - p ax s
clarament	n	k l a - r ax - m e1 n
clarificar	n	k l ax - r i - f i - k a1
claríssim	n	k l ax - r i1 - s i m
clatellada	n	k l ax - t ax - L a1 - D ax
clàudia	n	k l a1 - u - D i - ax
claudicar	n	k l ax uw - D i - k a1
claudi	n	k l a1 uw - D i
clauer	n	k l ax - w e1
clauers	n	k l ax - w e1 s
clauota	n	k l ax - w O1 - t ax
claustrofòbica	n	k l ax uw s - t r u - f O1 - B i - k ax
cleveland	n	k l ax - B ax - l a1 n
clic	n	k l i1 k
client	n	k l i - e1 n
clients	n	k l i - e1 n s
cliquem	n	k l i - k E1 m
cliques	n	k l i1 - k ax s
cliqueu	n	k l i - k E1 uw
cliqui	n	k l i1 - k i
clissar	n	k l i - s a1
cliva	n	k l i1 - B ax
clons	n	k l o1 n s
clor	n	k l O1 rr
clotets	n	k l u - t E1 t s
club	n	k l u1 p
clubs	n	k l u1 p s
clucs	n	k l u1 k s
coadjutor	n	k u - ax d - Z u - t o1
coàgul	n	k u - a1 - G u l
coalició	n	k u - ax - l i - s i - o1
cobejada	n	k u - B ax - Z a1 - D ax
cobertura	n	k u - B ax rr - t u1 - r ax
cobi	n	k O1 - B i
coça	n	k o1 - s ax
coco	n	k o1 - k u
còctels	n	k O1 k - t ax l s
codifica	n	k u - D i - f i1 - k ax
coets	n	k u - E1 t s
cofoi	n	k u - f O1 j
cognom	n	k u g - n O1 m
cognoms	n	k u g - n O1 m s
coi	n	k O1 j
coincidents	n	k u - i n - s i - D e1 n s
coixa	n	k o1 - S ax
coixinet	n	k u - S i - n E1 t
colar	n	k u - l a1
coliflor	n	k O - l i - f l O1
colino	n	k u - l i1 - n u
col	n	k O1 l
col·lapsada	n	k u - l ax p - s a1 - D ax
col·leccionable	n	k u - l ax k - s i - u - n a1 b - b l ax
col·leccionisme	n	k u - l ax k - s i - u - n i1 z - m ax
col·legues	n	k u - l E1 - G ax s
collonades	n	k u - L u - n a1 - D ax s
collons	n	k u - L o1 n s
collonut	n	k u - L u - n u1 t
collserola	n	k O L - s ax - r O1 - l ax
coloma	n	k u - l o1 - m ax
colom	n	k u - l o1 m
coloms	n	k u - l o1 m s
coloraines	n	k u - l u - r a1 j - n ax s
colpejar	n	k u l - p ax - Z a1
colze	n	k o1 l - z ax
comas	n	k o1 - m ax s
comèdia	n	k u - m E1 - D i - ax
comercialitza	n	k u - m ax rr - s i - ax - l i1 d - z ax
comercialitzava	n	k u - m ax rr - s i - ax - l i d - z a1 - B ax
comercialitzi	n	k u - m ax rr - s i - ax - l i1 d - z i
cometes	n	k u - m E1 - t ax s
còmic	n	k O1 - m i k
còmics	n	k O1 - m i k s
còmiques	n	k O1 - m i - k ax s
comissari	n	k u - m i - s a1 - r i
comissionat	n	k u - m i - s i - u - n a1 t
comissura	n	k u - m i - s u1 - r ax
commemoració	n	k u m - m ax - m u - r ax - s i - o1
commou	n	k u m - m O1 uw
còmodament	n	k O - m u - D ax - m e1 n
comodí	n	k u - m u - D i1
comoditat	n	k u - m u - D i - t a1 t
companya	n	k u m - p a1 - J ax
companyes	n	k u m - p a1 - J ax s
comparatius	n	k u m - p ax - r ax - t i1 uw s
compareixença	n	k u m - p ax - r ax - S E1 n - s ax
comparèixer	n	k u m - p ax - r E1 - S ax
comparseria	n	k u m - p ax rr - s ax - r i1 - ax
comparsero	n	k u m - p ax rr - s e1 - r u
comparseros	n	k u m - p ax rr - s e1 - r u s
compartició	n	k u m - p ax rr - t i - s i - o1
competició	n	k u m - p ax - t i - s i - o1
competitiva	n	k u m - p ax - t i - t i1 - B ax
compilador	n	k u m - p i - l ax - D o1
complaença	n	k u m - p l ax - E1 n - s ax
complauen	n	k u m - p l a1 - w ax n
compleció	n	k u m - p l ax - s i - o1
complementem	n	k u m - p l ax - m ax n - t E1 m
completament	n	k u m - p l E - t ax - m e1 n
còmplices	n	k O1 m - p l i - s ax s
complicitat	n	k u m - p l i - s i - t a1 t
composa	n	k u m - p o1 - z ax
compradors	n	k u m - p r ax - D o1 s
compravenda	n	k o m - p r ax - B E1 n - d ax
comprensiva	n	k u m - p r ax n - s i1 - B ax
compressió	n	k u m - p r ax - s i - o1
comprovació	n	k u m - p r u - B ax - s i - o1
compulsiu	n	k u m - p u l - s i1 uw
compulsivament	n	k u m - p u l - s i - B ax - m e1 n
compungit	n	k u m - p u n - Z i1 t
computadors	n	k u m - p u - t ax - D o1 s
comunitària	n	k u - m u - n i - t a1 - r i - ax
còncau	n	k O1 N - k ax uw
concertació	n	k u n - s ax rr - t ax - s i - o1
conciliació	n	k u n - s i - l i - ax - s i - o1
concisa	n	k u n - s i1 - z ax
concrecions	n	k u N - k r ax - s i - o1 n s
concretament	n	k u N - k r e - t ax - m e1 n
concupiscència	n	k u N - k u - p i - s E1 n - s i - ax
condensadors	n	k u n - d ax n - s ax - D o1 s
condicional	n	k u n - d i - s i - u - n a1 l
condol	n	k u n - d O1 l
conducció	n	k u n - d u k - s i - o1
conductor	n	k u n - d u k - t o1
coneixedors	n	k u - n ax - S ax - D o1 s
coneixéssim	n	k u - n ax - S e1 - s i m
coneixessiu	n	k u - n ax - S ax - s i1 uw
coneixi	n	k u - n E1 - S i
confidencialitat	n	k u m - f i - D ax n - s i - ax - l i - t a1 t
confidencial	n	k u m - f i - D ax n - s i - a1 l
confident	n	k u m - f i - D e1 n
configurable	n	k u m - f i - G u - r a1 b - b l ax
confiscar	n	k u m - f i s - k a1
conflictiva	n	k u m - f l i k - t i1 - B ax
conflictives	n	k u m - f l i k - t i1 - B ax s
conflictivitat	n	k u m - f l i k - t i - B i - t a1 t
conforme	n	k u m - f o1 rr - m ax
conformitat	n	k u m - f u rr - m i - t a1 t
confort	n	k u m - f O1 rr t
confraries	n	k u m - f r ax - r i1 - ax s
confronta	n	k u m - f r o1 n - t ax
confrontarem	n	k u m - f r u n - t ax - r E1 m
congela	n	k u n - Z E1 - l ax
congeniar	n	k u n - Z ax - n i - a1
congruent	n	k u N - g r u - e1 n
cònjuge	n	k O1 n - Z u - Z ax
conjuminar	n	k u n - Z u - m i - n a1
conjura	n	k u n - Z u1 - r ax
connectada	n	k u n - n ax k - t a1 - D ax
connectades	n	k u n - n ax k - t a1 - D ax s
connecta	n	k u n - n e1 k - t ax
connectar	n	k u n - n ax k - t a1
connecteu	n	k u n - n ax k - t E1 uw
conselleria	n	k u n - s ax - L ax - r i1 - ax
conselleries	n	k u n - s ax - L ax - r i1 - ax s
conserge	n	k u n - s E1 rr - Z ax
considerablement	n	k u n - s i - D ax - r a b - b l ax - m e1 n
consistència	n	k u n - s i s - t E1 n - s i - ax
consistori	n	k u n - s i s - t O1 - r i
consolà	n	k u n - s u - l a1
consolar	n	k u n - s u - l a1
consol	n	k u n - s O1 l
consorci	n	k u n - s O1 rr - s i
constància	n	k u n s - t a1 n - s i - ax
constantment	n	k u n s - t a m - m e1 n
constructores	n	k u n s - t r u k - t o1 - r ax s
consultar	n	k u n - s u l - t a1
consulteu	n	k u n - s u l - t E1 uw
consulti	n	k u n - s u1 l - t i
consumidora	n	k u n - s u - m i - D o1 - r ax
contacta	n	k u n - t a1 k - t ax
contacteu	n	k u n - t ax k - t E1 uw
contactin	n	k u n - t a1 k - t i n
contagiosa	n	k u n - t ax - Z i - o1 - z ax
contaminació	n	k u n - t ax - m i - n ax - s i - o1
contar	n	k u n - t a1
conte	n	k o1 n - t ax
contem	n	k u n - t E1 m
contemplacions	n	k u n - t ax m - p l ax - s i - o1 n s
contenidor	n	k u n - t ax - n i - D o1
contes	n	k o1 n - t ax s
contextual	n	k u n - t ax k s - t u - a1 l
contínuament	n	k u n - t i - n u - ax - m e1 n
contorns	n	k u n - t o1 rr n s
contractar	n	k u n - t r ax k - t a1
contradeien	n	k u n - t r ax - D E1 - y ax n
contraoferta	n	k O n - t r ax - u - f E1 rr - t ax
contraportada	n	k O n - t r ax - p u rr - t a1 - D ax
contraposició	n	k O n - t r ax - p u - z i - s i - o1
contraproduent	n	k O n - t r ax - p r u - D u - e1 n
contrariada	n	k u n - t r ax - r i - a1 - D ax
contràriament	n	k u n - t r a - r i - ax - m e1 n
contrasenya	n	k O n - t r ax - s E1 - J ax
contratemps	n	k O n - t r ax - t e1 m s
contribuents	n	k u n - t r i - B u - e1 n s
contributives	n	k u n - t r i - B u - t i1 - B ax s
contrincant	n	k u n - t r i N - k a1 n
contrincants	n	k u n - t r i N - k a1 n s
controlador	n	k u n - t r u - l ax - D o1
convenció	n	k u m - b ax n - s i - o1
convencionalisme	n	k u m - b ax n - s i - u - n ax - l i1 z - m ax
conveni	n	k u m - b E1 - n i
converso	n	k u m - b E1 rr - s u
convex	n	k u m - b E1 k s
convida	n	k u m - b i1 - D ax
convidant	n	k u m - b i - D a1 n
convidaria	n	k u m - b i - D ax - r i1 - ax
convidar	n	k u m - b i - D a1
convidat	n	k u m - b i - D a1 t
convidats	n	k u m - b i - D a1 t s
convido	n	k u m - b i1 - D u
conviure	n	k u m - b i1 uw - r ax
convivència	n	k u m - b i - B E1 n - s i - ax
convocar	n	k u m - b u - k a1
convocatòria	n	k u m - b u - k ax - t O1 - r i - ax
convoquen	n	k u m - b o1 - k ax n
convulsos	n	k u m - b u1 l - s u s
conya	n	k o1 - J ax
cooficials	n	k u - u - f i - s i - a1 l s
coordinador	n	k u - u r - D i - n ax - D o1
coordinat	n	k u - u r - D i - n a1 t
copenhague	n	k u - p ax - n a1 - G ax
copet	n	k u - p E1 t
còpia	n	k O1 - p i - ax
copiar	n	k u - p i - a1
còpies	n	k O1 - p i - ax s
copular	n	k u - p u - l a1
coquetejar	n	k u - k ax - t ax - Z a1
coratge	n	k u - r a1 d - Z ax
corbs	n	k o1 rr p s
cordada	n	k u r - D a1 - D ax
cordar	n	k u r - D a1
cordat	n	k u r - D a1 t
cornelisse	n	k u rr - n ax - l i1 - s ax
coronant	n	k u - rr u - n a1 n
coronat	n	k u - r u - n a1 t
corporatius	n	k u rr - p u - r ax - t i1 uw s
còrpores	n	k O1 rr - p u - r ax s
corpus	n	k O1 rr - p u s
correcció	n	k u - rr ax k - s i - o1
correccions	n	k u - rr ax k - s i - o1 n s
correctament	n	k u - rr E k - t ax - m e1 n
corrector	n	k u - rr ax k - t o1
corredisses	n	k u - rr ax - D i1 - s ax s
correfoc	n	k u - rr ax - f O1 k
corresponsal	n	k u - rr ax s - p u n - s a1 l
correus	n	k u - rr E1 uw s
corriol	n	k u - rr i - O1 l
corriols	n	k u - rr i - O1 l s
cortesia	n	k u rr - t ax - z i1 - ax
cortineta	n	k u rr - t i - n E1 - t ax
corunya	n	k u - rr u1 - J ax
corunyès	n	k u - rr u - J E1 s
cosidor	n	k u - z i - D o1
cosinus	n	k u - s i1 - n u s
cosmopolita	n	k u z - m u - p u - l i1 - t ax
cosmovisions	n	k O z - m u - B i - z i - o1 n s
costelles	n	k u s - t e1 - L ax s
costumistes	n	k u s - t u - m i1 s - t ax s
cota	n	k O1 - t ax
cotització	n	k u - t i d - z ax - s i - o1
cotorres	n	k u - t o1 - rr ax s
coure	n	k O1 uw - r ax
covardia	n	k u - B ax r - D i1 - ax
covard	n	k u - B a1 rr t
covards	n	k u - B a1 rr s
cranial	n	k r ax - n i - a1 l
crani	n	k r a1 - n i
creativitat	n	k r e - ax - t i - B i - t a1 t
credo	n	k r E1 - D u
creïbles	n	k r ax - i1 b - b l ax s
créixens	n	k r e1 - S ax n s
cremor	n	k r ax - m o1
crepitegen	n	k r ax - p i - t E1 - Z ax n
creta	n	k r E1 - t ax
creuer	n	k r ax - w e1
criat	n	k r i - a1 t
criats	n	k r i - a1 t s
criaven	n	k r i - a1 - B ax n
crien	n	k r i1 - ax n
cries	n	k r i1 - ax s
criminal	n	k r i - m i - n a1 l
crims	n	k r i1 m s
crins	n	k r i1 n s
crispa	n	k r i1 s - p ax
crispetes	n	k r i s - p E1 - t ax s
cristallets	n	k r i s - t ax - L E1 t s
cristall	n	k r i s - t a1 L
cristalls	n	k r i s - t a1 L s
cristina	n	k r i s - t i1 - n ax
crist	n	k r i1 s t
croàcia	n	k r u - a1 - s i - ax
croada	n	k r u - a1 - D ax
croissant	n	k r u - ax - s a1 n
cromos	n	k r o1 - m u s
cromosomes	n	k r u - m u - z o1 - m ax s
crua	n	k r u1 - ax
crueltat	n	k r u - ax l - t a1 t
cruentes	n	k r u - e1 n - t ax s
cruixeix	n	k r u - S E1 S
cruspir	n	k r u s - p i1
cruspit	n	k r u s - p i1 t
crussant	n	k r u - s a1 n
cuba	n	k u1 - B ax
cubà	n	k u - B a1
cubana	n	k u - B a1 - n ax
cubata	n	k u - B a1 - t ax
cúbics	n	k u1 - B i k s
cuers	n	k u - e1 s
cugat	n	k u - G a1 t
cuida	n	k u1 j - D ax
cuidant	n	k u j - D a1 n
cuidar	n	k u j - D a1
cuidava	n	k u j - D a1 - B ax
cuidés	n	k u j - D e1 s
cuinaria	n	k u j - n ax - r i1 - ax
cuinar	n	k u j - n a1
cuinats	n	k u j - n a1 t s
cuinera	n	k u j - n e1 - r ax
cuinés	n	k u j - n e1 s
cuirassada	n	k u j - r ax - s a1 - D ax
culebró	n	k u - l ax - B r o1
cullereta	n	k u - L ax - r E1 - t ax
culpar	n	k u l - p a1
cultius	n	k u l - t i1 uw s
cúmul	n	k u1 - m u l
cuneta	n	k u - n E1 - t ax
cupido	n	k u - p i1 - D u
cuques	n	k u1 - k ax s
curador	n	k u - r ax - D o1
curar	n	k u - r a1
curiosament	n	k u - r i - o - z ax - m e1 n
currículum	n	k u - rr i1 - k u - l u m
cursa	n	k u1 rr - s ax
cursen	n	k u1 rr - s ax n
curses	n	k u1 rr - s ax s
cursi	n	k u1 rr - s i
cursor	n	k u rr - s o1
curtcircuit	n	k u rr t - s i rr - k u1 j t
custòdia	n	k u s - t O1 - D i - ax
daga	n	d a1 - G ax
dakar	n	d ax - k a1
dallas	n	d a1 - L ax s
dames	n	d a1 - m ax s
damià	n	d ax - m i - a1
damisel·la	n	d ax - m i - z E1 - l ax
danesos	n	d ax - n E1 - z u s
dansa	n	d a1 n - s ax
danya	n	d a1 - J ax
danyar	n	d ax - J a1
datileres	n	d ax - t i - l e1 - r ax s
dàtils	n	d a1 - t i l s
daus	n	d a1 uw s
david	n	d ax - B i1 t
deambular	n	d e - ax m - b u - l a1
dèbit	n	d E1 - B i t
debò	n	d ax - B O1
debutant	n	d ax - B u - t a1 n
decadent	n	d ax - k ax - D e1 n
decapitar	n	d ax - k ax - p i - t a1
decebuda	n	d ax - s ax - B u1 - D ax
decebut	n	d ax - s ax - B u1 t
decepció	n	d ax - s ax p - s i - o1
decep	n	d ax - s E1 p
decibels	n	d ax - s i - B E1 l s
decimals	n	d ax - s i - m a1 l s
dedicació	n	d ax - D i - k ax - s i - o1
deessa	n	d ax - E1 - s ax
defalleixen	n	d ax - f ax - L E1 - S ax n
defensor	n	d ax - f ax n - s o1
defensors	n	d ax - f ax n - s o1 s
definitivament	n	d ax - f i - n i - t i - B ax - m e1 n
deflagració	n	d ax - f l ax - G r ax - s i - o1
deformi	n	d ax - f O1 rr - m i
degenera	n	d ax - Z ax - n e1 - r ax
degenerativa	n	d ax - Z ax - n ax - r ax - t i1 - B ax
degraden	n	d ax - G r a1 - D ax n
deixondeix	n	d ax - S u n - d E1 S
delator	n	d ax - l ax - t o1
delerosa	n	d ax - l ax - r o1 - z ax
delhi	n	d E1 - l i
deliciós	n	d ax - l i - s i - o1 s
demandar	n	d ax - m ax n - d a1
demolir	n	d ax - m u - l i1
dempeus	n	d ax m - p E1 uw s
denegada	n	d ax - n ax - G a1 - D ax
densament	n	d E n - s ax - m e1 n
dentadura	n	d ax n - t ax - D u1 - r ax
dentifrici	n	d ax n - t i - f r i1 - s i
denúncies	n	d ax - n u1 n - s i - ax s
deontologia	n	d ax - u n - t u - l u - Z i1 - ax
depauperació	n	d ax - p ax uw - p ax - r ax - s i - o1
depilar	n	d ax - p i - l a1
deposar	n	d ax - p u - z a1
deposicionals	n	d ax - p u - z i - s i - u - n a1 l s
depurador	n	d ax - p u - r ax - D o1
dèries	n	d E1 - r i - ax s
derrapat	n	d ax - rr ax - p a1 t
derrotat	n	d ax - rr u - t a1 t
desaconsellada	n	d ax - z ax - k u n - s ax - L a1 - D ax
desacord	n	d ax - z ax - k O1 rr t
desactivat	n	d ax - z ax k - t i - B a1 t
desa	n	d e1 - z ax
desafiament	n	d ax - z ax - f i - ax - m e1 n
desafiants	n	d ax - z ax - f i - a1 n s
desagradable	n	d ax - z ax - G r ax - D a1 b - b l ax
desagradables	n	d ax - z ax - G r ax - D a1 b - b l ax s
desallotjat	n	d ax - z ax - L u d - Z a1 t
desamor	n	d ax - z ax - m o1 rr
desamors	n	d ax - z ax - m o1 rr s
desanimar	n	d ax - z ax - n i - m a1
desànim	n	d ax - z a1 - n i m
desant	n	d ax - z a1 n
desar	n	d ax - z a1
desarmar	n	d ax - z ax rr - m a1
desastre	n	d ax - z a1 s - t r ax
desastres	n	d ax - z a1 s - t r ax s
desatenció	n	d ax - z ax - t ax n - s i - o1
desava	n	d ax - z a1 - B ax
desbocades	n	d ax z - B u - k a1 - D ax s
desbordar	n	d ax z - B u r - D a1
descalços	n	d ax s - k a1 l - s u s
descarat	n	d ax s - k ax - r a1 t
descàrrega	n	d ax s - k a1 - rr ax - G ax
descarta	n	d ax s - k a1 rr - t ax
descarten	n	d ax s - k a1 rr - t ax n
descendència	n	d ax - s ax n - d E1 n - s i - ax
descobridor	n	d ax s - k u - B r i - D o1
descobridors	n	d ax s - k u - B r i - D o1 s
descomptat	n	d ax s - k u m - t a1 t
descompte	n	d ax s - k o1 m - t ax
descomptes	n	d ax s - k o1 m - t ax s
desconcertada	n	d ax s - k u n - s ax rr - t a1 - D ax
desconnectar	n	d ax s - k u n - n ax k - t a1
descontrol	n	d ax s - k u n - t r O1 l
descosit	n	d ax s - k u - z i1 t
desdentada	n	d ax z - D ax n - t a1 - D ax
desdibuixats	n	d ax z - D i - B u - S a1 t s
desdir	n	d ax z - D i1
desdobla	n	d ax z - D o1 b - b l ax
desdoblar	n	d ax z - D u b - b l a1
desdoblat	n	d ax z - D u b - b l a1 t
desempallegar	n	d ax - z ax m - p ax - L ax - G a1
desenfocats	n	d ax - z ax m - f u - k a1 t s
desengany	n	d ax - z ax N - g a1 J
desentonar	n	d ax - z ax n - t u - n a1
desertor	n	d ax - z ax rr - t o1
desesperació	n	d ax - z ax s - p ax - r ax - s i - o1
desesperadament	n	d ax - z ax s - p ax - r a - D ax - m e1 n
desesperança	n	d ax - z ax s - p ax - r a1 n - s ax
desesper	n	d ax - z ax s - p e1 rr
desestimar	n	d ax - z ax s - t i - m a1
desfigurat	n	d ax s - f i - G u - r a1 t
desfilar	n	d ax s - f i - l a1
desgana	n	d ax z - G a1 - n ax
desgastats	n	d ax z - G ax s - t a1 t s
desgel	n	d ax - Z E1 l
desglaç	n	d ax z - G l a1 s
desglossa	n	d ax z - G l O1 - s ax
desglossar	n	d ax z - G l u - s a1
desgraciada	n	d ax z - G r ax - s i - a1 - D ax
desgracia	n	d ax z - G r ax - s i1 - ax
desgraciades	n	d ax z - G r ax - s i - a1 - D ax s
desgraciar	n	d ax z - G r ax - s i - a1
deshidratades	n	d ax - z i - D r ax - t a1 - D ax s
deshonest	n	d ax - z u - n e1 s t
desi	n	d e1 - z i
desinhibint	n	d ax - z i - n i - B i1 n
desinteressats	n	d ax - z i n - t ax - r ax - s a1 t s
deslliurament	n	d ax z - L i uw - r ax - m e1 n
deslliureu	n	d ax z - L i uw - r E1 uw
deslluïts	n	d ax z - L u - i1 t s
deslocalització	n	d ax z - l u - k ax - l i d - z ax - s i - o1
deslocalitzar	n	d ax z - l u - k ax - l i d - z a1
desmaiar	n	d ax z - m ax - y a1
desmai	n	d ax z - m a1 j
desmanegat	n	d ax z - m ax - n ax - G a1 t
desmantellament	n	d ax z - m ax n - t e - L ax - m e1 n
desmarcar	n	d ax z - m ax rr - k a1
desmesurada	n	d ax z - m ax - z u - r a1 - D ax
desmuntava	n	d ax z - m u n - t a1 - B ax
desordenat	n	d ax - z u r - D ax - n a1 t
desordre	n	d ax - z o1 r - D r ax
desordres	n	d ax - z o1 r - D r ax s
desorientat	n	d ax - z u - r i - ax n - t a1 t
despentinada	n	d ax s - p ax n - t i - n a1 - D ax
despertador	n	d ax s - p ax rr - t ax - D o1
desplegable	n	d ax s - p l ax - G a1 b - b l ax
desplegables	n	d ax s - p l ax - G a1 b - b l ax s
desploma	n	d ax s - p l o1 - m ax
desplomar	n	d ax s - p l u - m a1
desplom	n	d ax s - p l o1 m
despreci	n	d ax s - p r e1 - s i
desprogramació	n	d ax s - p r u - G r ax - m ax - s i - o1
desqualificada	n	d ax s - k w ax - l i - f i - k a1 - D ax
destacables	n	d ax s - t ax - k a1 b - b l ax s
destapar	n	d ax s - t ax - p a1
destapava	n	d ax s - t ax - p a1 - B ax
destinació	n	d ax s - t i - n ax - s i - o1
destinacions	n	d ax s - t i - n ax - s i - o1 n s
destinataris	n	d ax s - t i - n ax - t a1 - r i s
destorb	n	d ax s - t o1 rr p
destorben	n	d ax s - t o1 r - B ax n
destresa	n	d ax s - t r E1 - z ax
destrossa	n	d ax s - t r O1 - s ax
destrossat	n	d ax s - t r u - s a1 t
destrossaven	n	d ax s - t r u - s a1 - B ax n
desvalgut	n	d ax z - B ax l - G u1 t
desvalguts	n	d ax z - B ax l - G u1 t s
desvariejar	n	d ax z - B ax - r i - ax - Z a1
desviament	n	d ax z - B i - ax - m e1 n
desxifrar	n	d ax - S i - f r a1
detecció	n	d ax - t ax k - s i - o1
detectiu	n	d ax - t ax k - t i1 uw
detenció	n	d ax - t ax n - s i - o1
detesto	n	d ax - t e1 s - t u
detingudament	n	d ax - t i N - g u - D ax - m e1 n
detingui	n	d ax - t i1 N - g i
detlef	n	d ax l - l e1 f
detroit	n	d ax - t r O1 j t
devastador	n	d ax - B ax s - t ax - D o1
devoció	n	d ax - B u - s i - o1
devolució	n	d ax - B u - l u - s i - o1
devolucions	n	d ax - B u - l u - s i - o1 n s
devorat	n	d ax - B u - r a1 t
devorava	n	d ax - B u - r a1 - B ax
devoro	n	d ax - B o1 - r u
diabètic	n	d i - ax - B E1 - t i k
diada	n	d i - a1 - D ax
diadema	n	d i - ax - D E1 - m ax
diagnòstics	n	d i - ax g - n O1 s - t i k s
diapositives	n	d i - ax - p u - z i - t i1 - B ax s
diàriament	n	d i - a - r i - ax - m e1 n
dibuixables	n	d i - B u - S a1 b - b l ax s
dictamen	n	d i k - t a1 - m ax n
didàctic	n	d i - D a1 k - t i k
dieta	n	d i - E1 - t ax
dietari	n	d i - ax - t a1 - r i
difunt	n	d i - f u1 n
digitalització	n	d i - Z i - t ax - l i d - z ax - s i - o1
digitalment	n	d i - Z i - t a l - m e1 n
digitals	n	d i - Z i - t a1 l s
dígit	n	d i1 - Z i t
dilació	n	d i - l ax - s i - o1
dilapidada	n	d i - l ax - p i - D a1 - D ax
dilatació	n	d i - l ax - t ax - s i - o1
dilluns	n	d i - L u1 n s
dilueix	n	d i - l u - E1 S
dimarts	n	d i - m a1 rr s
dimecres	n	d i - m e1 - k r ax s
dinamarca	n	d i - n ax - m a1 rr - k ax
dinamisme	n	d i - n ax - m i1 z - m ax
dínars	n	d i1 - n ax s
dinosaures	n	d i - n u - z a1 uw - r ax s
diòxid	n	d i - O1 k - s i t
diplomatura	n	d i - p l u - m ax - t u1 - r ax
directament	n	d i - r E k - t ax - m e1 n
directori	n	d i - r ax k - t O1 - r i
directoris	n	d i - r ax k - t O1 - r i s
directrius	n	d i - r ax k - t r i1 uw s
dírhams	n	d i1 - r ax m s
dirhams	n	d i - r a1 m s
disbarat	n	d i z - B ax - r a1 t
disbauxa	n	d i z - B a1 uw - S ax
disbauxat	n	d i z - B ax uw - S a1 t
discapacitat	n	d i s - k ax - p ax - s i - t a1 t
discjòqueis	n	d i s g - Z O1 - k ax j s
discoteca	n	d i s - k u - t E1 - k ax
discoteques	n	d i s - k u - t E1 - k ax s
discrepància	n	d i s - k r ax - p a1 n - s i - ax
discrepi	n	d i s - k r e1 - p i
discrepo	n	d i s - k r e1 - p u
discriminació	n	d i s - k r i - m i - n ax - s i - o1
discriminatòria	n	d i s - k r i - m i - n ax - t O1 - r i - ax
disculpes	n	d i s - k u1 l - p ax s
disculpeu	n	d i s - k u l - p E1 uw
disfressada	n	d i s - f r ax - s a1 - D ax
disfressa	n	d i s - f r E1 - s ax
disfressat	n	d i s - f r ax - s a1 t
disfrutes	n	d i s - f r u1 - t ax s
disfruteu	n	d i s - f r u - t E1 uw
disney	n	d i z - n E1 j
disparada	n	d i s - p ax - r a1 - D ax
dispara	n	d i s - p a1 - r ax
disparat	n	d i s - p ax - r a1 t
disparés	n	d i s - p ax - r e1 s
dispareu	n	d i s - p ax - r E1 uw
dispars	n	d i s - p a1 rr s
disponibilitat	n	d i s - p u - n i - B i - l i - t a1 t
disponible	n	d i s - p u - n i1 b - b l ax
disponibles	n	d i s - p u - n i1 b - b l ax s
dispositiu	n	d i s - p u - z i - t i1 uw
dispositius	n	d i s - p u - z i - t i1 uw s
disputes	n	d i s - p u1 - t ax s
disquet	n	d i s - k E1 t
disruptor	n	d i z - rr u p - t o1
dissenyadora	n	d i - s ax - J ax - D o1 - r ax
dissenyar	n	d i - s ax - J a1
disseny	n	d i - s E1 J
dissertaven	n	d i - s ax rr - t a1 - B ax n
dissoldre	n	d i - s O1 l - d r ax
distaven	n	d i s - t a1 - B ax n
distendre	n	d i s - t e1 n - d r ax
distintiu	n	d i s - t i n - t i1 uw
distorsions	n	d i s - t u rr - s i - o1 n s
distribuïdor	n	d i s - t r i - B u - i - D o1
disturbis	n	d i s - t u1 r - B i s
diürna	n	d i - u1 rr - n ax
divaga	n	d i - B a1 - G ax
diversió	n	d i - B ax rr - s i - o1
diverteixo	n	d i - B ax rr - t E1 - S u
divises	n	d i - B i1 - z ax s
divisibilitat	n	d i - B i - z i - B i - l i - t a1 t
divorci	n	d i - B O1 rr - s i
dobla	n	d o1 b - b l ax
doblatge	n	d u b - b l a1 d - Z ax
doblement	n	d o b - b l ax - m e1 n
docència	n	d u - s E1 n - s i - ax
doctes	n	d O1 k - t ax s
doctora	n	d u k - t o1 - r ax
doctoral	n	d u k - t u - r a1 l
dodecàedres	n	d u - D ax - k a1 - e - D r ax s
dogmàtics	n	d u g - m a1 - t i k s
dojo	n	d O1 - Z u
dòlar	n	d O1 - l ax rr
dòlars	n	d O1 - l ax rr s
dolçament	n	d o l - s ax - m e1 n
doll	n	d o1 L
dolorós	n	d u - l u - r o1 s
doloroses	n	d u - l u - r o1 - z ax s
domèstica	n	d u - m E1 s - t i - k ax
domesticar	n	d u - m ax s - t i - k a1
domèstic	n	d u - m E1 s - t i k
domicili	n	d u - m i - s i1 - l i
dominadors	n	d u - m i - n ax - D o1 s
dominó	n	d u - m i - n o1
donostiarra	n	d u - n u s - t i - a1 - rr ax
dòping	n	d O1 - p i N
dosificats	n	d u - z i - f i - k a1 t s
dots	n	d O1 t s
drak	n	d r a1 k
dràstiques	n	d r a1 s - t i - k ax s
dreceres	n	d r ax - s e1 - r ax s
dropo	n	d r O1 - p u
dublín	n	d u - B l i1 n
duo	n	d u1 - o
dúplex	n	d u1 - p l ax k s
duplicant	n	d u - p l i - k a1 n
duplicats	n	d u - p l i - k a1 t s
duríssim	n	d u - r i1 - s i m
dury	n	d u1 - r i
düsseldorf	n	d u - s ax l - d O1 rr f
dutxa	n	d u1 t - S ax
dutxar	n	d u t - S a1
dutxes	n	d u1 t - S ax s
e	n	E1
ebre	n	e1 - B r ax
eclesiàstic	n	ax - k l ax - z i - a1 s - t i k
eclipsi	n	ax - k l i1 p - s i
ecoenvasos	n	ax - k u - ax m - b a1 - z u s
ecologistes	n	ax - k u - l u - Z i1 s - t ax s
ecosistema	n	E - k u - s i s - t e1 - m ax
edgar	n	E1 d - g ax rr
edita	n	ax - D i1 - t ax
editades	n	ax - D i - t a1 - D ax s
editar	n	ax - D i - t a1
editaré	n	ax - D i - t ax - r e1
editat	n	ax - D i - t a1 t
editeu	n	ax - D i - t E1 uw
editorial	n	ax - D i - t u - r i - a1 l
eduard	n	ax - D u - a1 rr t
educadament	n	ax - D u - k a - D ax - m e1 n
edward	n	ax D - b a1 rr t
efectivament	n	ax - f ax k - t i - B ax - m e1 n
egara	n	ax - G a1 - r ax
egipci	n	ax - Z i1 p - s i
egipcis	n	ax - Z i1 p - s i s
egipte	n	ax - Z i1 p - t ax
ego	n	e1 - G o
egoista	n	ax - G u - i1 s - t ax
ególatra	n	ax - G o1 - l ax - t r ax
eindhoven	n	ax j n - d o1 - B ax n
eivissa	n	ax j - B i1 - s ax
eivissencs	n	ax j - B i - s E1 N s
eiximenis	n	ax - S i - m E1 - n i s
eixiré	n	ax - S i - r e1
eixorcs	n	ax - S o1 rr k s
ejecció	n	ax - Z ax k - s i - o1
elàstic	n	ax - l a1 s - t i k
elda	n	E1 l - d ax
elèctrica	n	ax - l E1 k - t r i - k ax
electricitat	n	ax - l ax k - t r i - s i - t a1 t
elèctrics	n	ax - l E1 k - t r i k s
electrònica	n	ax - l ax k - t r O1 - n i - k ax
electrònic	n	ax - l ax k - t r O1 - n i k
electrònics	n	ax - l ax k - t r O1 - n i k s
elegant	n	ax - l ax - G a1 n
elegants	n	ax - l ax - G a1 n s
elfs	n	E1 l f s
Èlia	n	E1 - l i - ax
elisabet	n	ax - l i - z ax - B E1 t
elisenda	n	ax - l i - z e1 n - d ax
elit	n	ax - l i1 t
elogi	n	ax - l O1 - Z i
eloi	n	ax - l O1 j
embadalida	n	ax m - b ax - D ax - l i1 - D ax
embafadora	n	ax m - b ax - f ax - D o1 - r ax
embalar	n	ax m - b ax - l a1
embaràs	n	ax m - b ax - r a1 s
embarassada	n	ax m - b ax - r ax - s a1 - D ax
embolcallava	n	ax m - b u l - k ax - L a1 - B ax
embolcall	n	ax m - b u l - k a1 L
emborratxa	n	ax m - b u - rr a1 t - S ax
embranzida	n	ax m - b r ax n - z i1 - D ax
embrutat	n	ax m - b r u - t a1 t
embrutats	n	ax m - b r u - t a1 t s
embrutes	n	ax m - b r u1 - t ax s
emergència	n	ax - m ax rr - Z E1 n - s i - ax
emfatitzant	n	ax m - f ax - t i d - z a1 n
emigrada	n	ax - m i - G r a1 - D ax
emigrar	n	ax - m i - G r a1
emissió	n	ax - m i - s i - o1
emissores	n	ax - m i - s o1 - r ax s
emmagatzemar	n	ax m - m ax - G ax d - z ax - m a1
emmagatzematge	n	ax m - m ax - G ax d - z ax - m a1 d - Z ax
emmagatzemats	n	ax m - m ax - G ax d - z ax - m a1 t s
emmarcades	n	ax m - m ax rr - k a1 - D ax s
emoció	n	ax - m u - s i - o1
emocionant	n	ax - m u - s i - u - n a1 n
emocionat	n	ax - m u - s i - u - n a1 t
emocions	n	ax - m u - s i - o1 n s
emperador	n	ax m - p ax - r ax - D o1
emperadors	n	ax m - p ax - r ax - D o1 s
empesquen	n	ax m - p E1 s - k ax n
empitjori	n	ax m - p i d - Z o1 - r i
empobrit	n	ax m - p u - B r i1 t
empordà	n	ax m - p u r - D a1
emprenedors	n	ax m - p r ax - n ax - D o1 s
emprenyada	n	ax m - p r ax - J a1 - D ax
emprenyades	n	ax m - p r ax - J a1 - D ax s
emprenyar	n	ax m - p r ax - J a1
emprenyis	n	ax m - p r E1 - J i s
empresarial	n	ax m - p r ax - z ax - r i - a1 l
empresarials	n	ax m - p r ax - z ax - r i - a1 l s
empresonades	n	ax m - p r ax - z u - n a1 - D ax s
empresonats	n	ax m - p r ax - z u - n a1 t s
emprovareu	n	ax m - p r u - B ax - r E1 uw
empúries	n	ax m - p u1 - r i - ax s
emulació	n	ax - m u - l ax - s i - o1
emulacions	n	ax - m u - l ax - s i - o1 n s
encabeixi	n	ax N - k ax - B E1 - S i
encadenar	n	ax N - k ax - D ax - n a1
encaminada	n	ax N - k ax - m i - n a1 - D ax
encaminem	n	ax N - k ax - m i - n E1 m
encanta	n	ax N - k a1 n - t ax
encantadora	n	ax N - k ax n - t ax - D o1 - r ax
encantador	n	ax N - k ax n - t ax - D o1
encantava	n	ax N - k ax n - t a1 - B ax
encanteri	n	ax N - k ax n - t E1 - r i
encapçalada	n	ax N - k ax p - s ax - l a1 - D ax
encarna	n	ax N - k a1 rr - n ax
encàrrec	n	ax N - k a1 - rr ax k
encàrrecs	n	ax N - k a1 - rr ax k s
encefalopaties	n	ax n - s ax - f ax - l u - p ax - t i1 - ax s
encegadora	n	ax n - s ax - G ax - D o1 - r ax
encenedors	n	ax n - s ax - n ax - D o1 s
encerclaran	n	ax n - s ax rr - k l ax - r a1 n
encerclar	n	ax n - s ax rr - k l a1
encertar	n	ax n - s ax rr - t a1
encertem	n	ax n - s ax rr - t E1 m
encerto	n	ax n - s E1 rr - t u
enciclopèdia	n	ax n - s i - k l u - p E1 - D i - ax
encisaven	n	ax n - s i - z a1 - B ax n
enclavament	n	ax N - k l ax - B ax - m e1 n
encoixinades	n	ax N - k u - S i - n a1 - D ax s
encoratjo	n	ax N - k u - r a1 d - Z u
encreuament	n	ax N - k r ax - w ax - m e1 n
encreuaments	n	ax N - k r ax - w ax - m e1 n s
encuriosides	n	ax N - k u - r i - u - z i1 - D ax s
encuriosit	n	ax N - k u - r i - u - z i1 t
endarrere	n	ax n - d ax - rr e1 - r ax
endaval	n	ax n - d ax - B a1 l
endèmica	n	ax n - d E1 - m i - k ax
enderrocar	n	ax n - d ax - rr u - k a1
endeutat	n	ax n - d ax uw - t a1 t
endívia	n	ax n - d i1 - B i - ax
endormiscats	n	ax n - d u rr - m i s - k a1 t s
endreçant	n	ax n - d r ax - s a1 n
endreço	n	ax n - d r e1 - s u
endureixin	n	ax n - d u - r E1 - S i n
endurir	n	ax n - d u - r i1
endurit	n	ax n - d u - r i1 t
ene	n	e1 - n ax
energètica	n	ax - n ax rr - Z E1 - t i - k ax
enfadar	n	ax m - f ax - D a1
enfadat	n	ax m - f ax - D a1 t
enfadessin	n	ax m - f ax - D e1 - s i n
enfadi	n	ax m - f a1 - D i
enfadis	n	ax m - f a1 - D i s
enfangaria	n	ax m - f ax N - g ax - r i1 - ax
enfarinat	n	ax m - f ax - r i - n a1 t
enfoti	n	ax m - f O1 - t i
enfront	n	ax m - f r o1 n
enfurismada	n	ax m - f u - r i z - m a1 - D ax
enfurismar	n	ax m - f u - r i z - m a1
enfurismat	n	ax m - f u - r i z - m a1 t
enfurismats	n	ax m - f u - r i z - m a1 t s
engabiats	n	ax N - g ax - B i - a1 t s
engalanar	n	ax N - g ax - l ax - n a1
enganxa	n	ax N - g a1 n - S ax
enganxada	n	ax N - g ax n - S a1 - D ax
enganxar	n	ax N - g ax n - S a1
enganxarem	n	ax N - g ax n - S ax - r E1 m
enganxareu	n	ax N - g ax n - S ax - r E1 uw
enganxen	n	ax N - g a1 n - S ax n
enganxoses	n	ax N - g ax n - S o1 - z ax s
enganyosa	n	ax N - g ax - J o1 - z ax
enganys	n	ax N - g a1 J s
enginyer	n	ax n - Z i - J e1
enginyeria	n	ax n - Z i - J ax - r i1 - ax
enginyers	n	ax n - Z i - J e1 s
enginys	n	ax n - Z i1 J s
engoleix	n	ax N - g u - l E1 S
engranatge	n	ax N - g r ax - n a1 d - Z ax
engrapa	n	ax N - g r a1 - p ax
engroguides	n	ax N - g r u - G i1 - D ax s
engrunetes	n	ax N - g r u - n E1 - t ax s
enguixar	n	ax N - g i - S a1
enigmàtica	n	ax - n i g - m a1 - t i - k ax
enigmes	n	ax - n i1 g - m ax s
enigmística	n	ax - n i g - m i1 s - t i - k ax
enjogassada	n	ax n - Z u - G ax - s a1 - D ax
enlairar	n	ax n - l ax j - r a1
enlairaria	n	ax n - l ax j - r ax - r i1 - ax
enllaços	n	ax J - L a1 - s u s
enllestida	n	ax J - L ax s - t i1 - D ax
enllestit	n	ax J - L ax s - t i1 t
enlluernaven	n	ax J - L u - ax rr - n a1 - B ax n
enmig	n	ax m - m i1 tS
enneàgon	n	ax n - n e - a1 - G u n
ennuegar	n	ax n - n u - ax - G a1
ennuvolat	n	ax n - n u - B u - l a1 t
enquadernat	n	ax N - k w ax - D ax rr - n a1 t
enrabiar	n	ax n - rr ax - B i - a1
enreda	n	ax n - rr e1 - D ax
enrera	n	ax n - rr e1 - r ax
enrere	n	ax n - rr e1 - r ax
enric	n	ax n - rr i1 k
enrique	n	ax n - rr i1 - k ax
enriquidora	n	ax n - rr i - k i - D o1 - r ax
enrotllo	n	ax n - rr o1 L - L u
ensabonades	n	ax n - s ax - B u - n a1 - D ax s
ensorrar	n	ax n - s u - rr a1
ensumar	n	ax n - s u - m a1
entapissats	n	ax n - t ax - p i - s a1 t s
entenedora	n	ax n - t ax - n ax - D o1 - r ax
entenedor	n	ax n - t ax - n ax - D o1
entonació	n	ax n - t u - n ax - s i - o1
entortolligats	n	ax n - t u rr - t u - L i - G a1 t s
entossudim	n	ax n - t u - s u - D i1 m
entranyable	n	ax n - t r ax - J a1 b - b l ax
entranyes	n	ax n - t r a1 - J ax s
entreacte	n	e n - t r ax - a1 k - t ax
entreactes	n	e n - t r ax - a1 k - t ax s
entrega	n	ax n - t r e1 - G ax
entregarà	n	ax n - t r ax - G ax - r a1
entregar	n	ax n - t r ax - G a1
entregat	n	ax n - t r ax - G a1 t
entrellaçades	n	e n - t r ax - L ax - s a1 - D ax s
entrellaçaven	n	e n - t r ax - L ax - s a1 - B ax n
entremaliadures	n	ax n - t r ax - m ax - l i - ax - D u1 - r ax s
entrenador	n	ax n - t r ax - n ax - D o1
entrenament	n	ax n - t r ax - n ax - m e1 n
entrenar	n	ax n - t r ax - n a1
entreobre	n	e n - t r ax - O1 - B r ax
entrepà	n	e n - t r ax - p a1
entrepans	n	e n - t r ax - p a1 n s
entrevistar	n	ax n - t r ax - B i s - t a1
entrevistat	n	ax n - t r ax - B i s - t a1 t
entrevistats	n	ax n - t r ax - B i s - t a1 t s
entusiàsticament	n	ax n - t u - z i - a s - t i - k ax - m e1 n
enuig	n	ax - n u1 tS
enumeració	n	ax - n u - m ax - r ax - s i - o1
envaeix	n	ax m - b ax - E1 S
envaïa	n	ax m - b ax - i1 - ax
envaint	n	ax m - b ax - i1 n
envair	n	ax m - b ax - i1
envasats	n	ax m - b ax - z a1 t s
envasos	n	ax m - b a1 - z u s
envejar	n	ax m - b ax - Z a1
envergadura	n	ax m - b ax r - G ax - D u1 - r ax
envesteix	n	ax m - b ax s - t E1 S
envestir	n	ax m - b ax s - t i1
enyorament	n	ax - J u - r ax - m e1 n
epilèpsia	n	ax - p i - l E1 p - s i - ax
equipatge	n	ax - k i - p a1 d - Z ax
equívocs	n	ax - k i1 - B u k s
eradicaran	n	ax - r ax - D i - k ax - r a1 n
eric	n	ax - r i1 k
erika	n	ax - r i1 - k ax
erodit	n	ax - r u - D i1 t
erosionada	n	ax - r u - z i - u - n a1 - D ax
erosionats	n	ax - r u - z i - u - n a1 t s
esbalaïda	n	ax z - B ax - l ax - i1 - D ax
esbandint	n	ax z - B ax n - d i1 n
esbarjo	n	ax z - B a1 rr - Z u
esbarzer	n	ax z - B ax rr - z e1
esbiaixada	n	ax z - B i - ax - S a1 - D ax
esborrany	n	ax z - B u - rr a1 J
esborranys	n	ax z - B u - rr a1 J s
esbroncada	n	ax z - B r u N - k a1 - D ax
esbroncar	n	ax z - B r u N - k a1
esbudellats	n	ax z - B u - D ax - L a1 t s
esbufega	n	ax z - B u - f E1 - G ax
esbufegués	n	ax z - B u - f ax - G e1 s
escaiola	n	ax s - k ax - y O1 - l ax
escalar	n	ax s - k ax - l a1
escalfor	n	ax s - k ax l - f o1
escalímetres	n	ax s - k ax - l i1 - m ax - t r ax s
escandalitzar	n	ax s - k ax n - d ax - l i d - z a1
escandalitzaven	n	ax s - k ax n - d ax - l i d - z a1 - B ax n
escandalosament	n	ax s - k ax n - d ax - l o - z ax - m e1 n
escapçada	n	ax s - k ax p - s a1 - D ax
escarabat	n	ax s - k ax - r ax - B a1 t
escenari	n	ax - s ax - n a1 - r i
escenaris	n	ax - s ax - n a1 - r i s
escenògraf	n	ax - s ax - n O1 - G r ax f
escepticisme	n	ax - s ax p - t i - s i1 z - m ax
esclau	n	ax s - k l a1 uw
esclaves	n	ax s - k l a1 - B ax s
escombra	n	ax s - k o1 m - b r ax
escopinades	n	ax s - k u - p i - n a1 - D ax s
escopinya	n	ax s - k u - p i1 - J ax
escopinyes	n	ax s - k u - p i1 - J ax s
escorça	n	ax s - k O1 rr - s ax
escribim	n	ax s - k r i - B i1 m
escriptori	n	ax s - k r i p - t O1 - r i
escrupolosament	n	ax s - k r u - p u - l o - z ax - m e1 n
escrutini	n	ax s - k r u - t i1 - n i
esculpides	n	ax s - k u l - p i1 - D ax s
esculpir	n	ax s - k u l - p i1
escultura	n	ax s - k u l - t u1 - r ax
escultures	n	ax s - k u l - t u1 - r ax s
esfinx	n	ax s - f i1 n S
esgarrapant	n	ax z - G ax - rr ax - p a1 n
esgarrapar	n	ax z - G ax - rr ax - p a1
esgarrifoses	n	ax z - G ax - rr i - f o1 - z ax s
esglaiada	n	ax z - G l ax - y a1 - D ax
esglai	n	ax z - G l a1 j
esglaons	n	ax z - G l ax - o1 n s
esgrogueint	n	ax z - G r u - G ax - i1 n
esgrogueït	n	ax z - G r u - G ax - i1 t
esguerro	n	ax z - G E1 - rr u
eslovàquia	n	ax z - l u - B a1 - k i - ax
eslovènia	n	ax z - l u - B E1 - n i - ax
esmicola	n	ax z - m i - k o1 - l ax
esmolant	n	ax z - m u - l a1 n
esmòquing	n	ax z - m O1 - k i N
esmorteïts	n	ax z - m u rr - t ax - i1 t s
esmorzars	n	ax z - m u rr - z a1 s
esmunyir	n	ax z - m u - J i1
esnob	n	ax z - n O1 p
eso	n	e1 - s o
espagueti	n	ax s - p ax - G E1 - t i
espaguetis	n	ax s - p ax - G E1 - t i s
espaiós	n	ax s - p ax - y o1 s
espantosa	n	ax s - p ax n - t o1 - z ax
espanya	n	ax s - p a1 - J ax
espardenyes	n	ax s - p ax r - D E1 - J ax s
esparracada	n	ax s - p ax - rr ax - k a1 - D ax
esparracar	n	ax s - p ax - rr ax - k a1
esparverada	n	ax s - p ax r - B ax - r a1 - D ax
espatllant	n	ax s - p ax L - L a1 n
espatllat	n	ax s - p ax L - L a1 t
especialment	n	ax s - p ax - s i - a l - m e1 n
especies	n	ax s - p ax - s i1 - ax s
espectacle	n	ax s - p ax k - t a1 - k l ax
espectacles	n	ax s - p ax k - t a1 - k l ax s
espectador	n	ax s - p ax k - t ax - D o1
espectadors	n	ax s - p ax k - t ax - D o1 s
especulacions	n	ax s - p ax - k u - l ax - s i - o1 n s
esperdenyes	n	ax s - p ax r - D E1 - J ax s
espermatozou	n	ax s - p ax rr - m ax - t u - z O1 uw
espiga	n	ax s - p i1 - G ax
espines	n	ax s - p i1 - n ax s
espirals	n	ax s - p i - r a1 l s
espiritualitat	n	ax s - p i - r i - t u - ax - l i - t a1 t
esplugues	n	ax s - p l u1 - G ax s
espolsa	n	ax s - p o1 l - s ax
espolsar	n	ax s - p u l - s a1
espongiformes	n	ax s - p u n - Z i - f o1 rr - m ax s
esponja	n	ax s - p O1 n - Z ax
esporuguit	n	ax s - p u - r u - G i1 t
esprémer	n	ax s - p r e1 - m ax
espurna	n	ax s - p u1 rr - n ax
espurnegen	n	ax s - p u rr - n E1 - Z ax n
esquadra	n	ax s - k w a1 - D r ax
esquelet	n	ax s - k ax - l E1 t
esquerda	n	ax s - k E1 r - D ax
esquerdes	n	ax s - k E1 r - D ax s
esquifida	n	ax s - k i - f i1 - D ax
esquifit	n	ax s - k i - f i1 t
esquinço	n	ax s - k i1 n - s u
esquindall	n	ax s - k i n - d a1 L
esquitxen	n	ax s - k i1 t - S ax n
esquizofrènic	n	ax s - k i - z u - f r E1 - n i k
estabornir	n	ax s - t ax - B u rr - n i1
estafador	n	ax s - t ax - f ax - D o1
estalvi	n	ax s - t a1 l - B i
estalvis	n	ax s - t a1 l - B i s
estampa	n	ax s - t a1 m - p ax
estancades	n	ax s - t ax N - k a1 - D ax s
estances	n	ax s - t a1 n - s ax s
estarrufa	n	ax s - t ax - rr u1 - f ax
estartit	n	ax s - t ax rr - t i1 t
estàtues	n	ax s - t a1 - t u - ax s
estatueta	n	ax s - t ax - t u - E1 - t ax
estela	n	ax s - t E1 - l ax
estenedor	n	ax s - t ax - n ax - D o1
estèreo	n	ax s - t E1 - r ax - o
esternuda	n	ax s - t ax rr - n u1 - D ax
estevan	n	ax s - t ax - B a1 n
estimbar	n	ax s - t i m - b a1
estimulació	n	ax s - t i - m u - l ax - s i - o1
estipula	n	ax s - t i - p u1 - l ax
estiueja	n	ax s - t i - w E1 - Z ax
estiuenca	n	ax s - t i - w E1 N - k ax
estocolm	n	ax s - t u - k o1 l m
estoicament	n	ax s - t O j - k ax - m e1 n
estómac	n	ax s - t o1 - m ax k
estrangeria	n	ax s - t r ax n - Z ax - r i1 - ax
estranyesa	n	ax s - t r ax - J E1 - z ax
estrateg	n	ax s - t r ax - t E1 k
estrelletes	n	ax s - t r ax - L E1 - t ax s
estrena	n	ax s - t r E1 - n ax
estrenada	n	ax s - t r ax - n a1 - D ax
estrenaran	n	ax s - t r ax - n ax - r a1 n
estrenar	n	ax s - t r ax - n a1
estrenat	n	ax s - t r ax - n a1 t
estrèpit	n	ax s - t r E1 - p i t
estrident	n	ax s - t r i - D e1 n
estris	n	E1 s - t r i s
estúpida	n	ax s - t u1 - p i - D ax
estupidesa	n	ax s - t u - p i - D E1 - z ax
estupideses	n	ax s - t u - p i - D E1 - z ax s
esturions	n	ax s - t u - r i - o1 n s
esvelta	n	ax z - B E1 l - t ax
esvoranc	n	ax z - B u - r a1 N
etiqueta	n	ax - t i - k E1 - t ax
etiquetes	n	ax - t i - k E1 - t ax s
etnògraf	n	ax d - n O1 - G r ax f
eua	n	E1 - w ax
euclidiana	n	ax uw - k l i - D i - a1 - n ax
eudald	n	ax uw - D a1 l
eudalt	n	ax uw - D a1 l
eufemísticament	n	ax uw - f ax - m i s - t i - k ax - m e1 n
eufòric	n	ax uw - f O1 - r i k
euga	n	E1 uw - G ax
eui	n	E1 - w i
eulàlia	n	ax uw - l a1 - l i - ax
euro	n	E1 uw - r u
euromed	n	E uw - r u - m E1 t
europa	n	ax uw - r o1 - p ax
euroregió	n	E uw - r u - rr ax - Z i - o1
euros	n	E1 uw - r u s
eusebi	n	ax uw - z E1 - B i
euskera	n	ax uw s - k e1 - r ax
evans	n	ax - B a1 n s
evaporar	n	ax - B ax - p u - r a1
evidentment	n	ax - B i - D e m - m e1 n
ewing	n	ax - B i1 N
exactament	n	ax g - z a k - t ax - m e1 n
exaltació	n	ax g - z ax l - t ax - s i - o1
examic	n	E g - z ax - m i1 k
exclusivament	n	ax k s - k l u - z i - B ax - m e1 n
excursió	n	ax k s - k u rr - s i - o1
excursions	n	ax k s - k u rr - s i - o1 n s
excusa	n	ax k s - k u1 - z ax
excusar	n	ax k s - k u - z a1
excusi	n	ax k s - k u1 - z i
exempcions	n	ax g - z ax m - s i - o1 n s
exemplificant	n	ax g - z ax m - p l i - f i - k a1 n
exempts	n	ax g - z e1 m t s
exèrcit	n	ax g - z E1 rr - s i t
exhaust	n	ax g - z a1 uw s t
exhibia	n	ax g - z i - B i1 - ax
existencial	n	ax g - z i s - t ax n - s i - a1 l
existencials	n	ax g - z i s - t ax n - s i - a1 l s
exjugador	n	E g - Z u - G ax - D o1
exlíder	n	E g z - l i1 - D ax
exòtica	n	ax g - z O1 - t i - k ax
expandeixen	n	ax k s - p ax n - d E1 - S ax n
expectació	n	ax k s - p ax k - t ax - s i - o1
expectatives	n	ax k s - p ax k - t ax - t i1 - B ax s
expedicionari	n	ax k s - p ax - D i - s i - u - n a1 - r i
expedientada	n	ax k s - p ax - D i - ax n - t a1 - D ax
experta	n	ax k s - p E1 rr - t ax
experts	n	ax k s - p E1 rr s
explícitament	n	ax k s - p l i - s i - t ax - m e1 n
explorant	n	ax k s - p l u - r a1 n
explorar	n	ax k s - p l u - r a1
exploréssim	n	ax k s - p l u - r e1 - s i m
explosió	n	ax k s - p l u - z i - o1
explosions	n	ax k s - p l u - z i - o1 n s
explosius	n	ax k s - p l u - z i1 uw s
exportar	n	ax k s - p u rr - t a1
exporti	n	ax k s - p O1 rr - t i
expositiu	n	ax k s - p u - z i - t i1 uw
expressament	n	ax k s - p r e - s ax - m e1 n
expulsar	n	ax k s - p u l - s a1
exquisit	n	ax k s - k i - z i1 t
exsoci	n	E k - s O1 - s i
extinció	n	ax k s - t i n - s i - o1
extra	n	E1 k s - t r ax
extracció	n	ax k s - t r ax k - s i - o1
extraescolars	n	E k s - t r ax s - k u - l a1 rr s
extraïbles	n	E k s - t r ax - i1 b - b l ax s
extraradi	n	E k s - t r ax - rr a1 - D i
extravagant	n	ax k s - t r ax - B ax - G a1 n
extremenya	n	ax k s - t r ax - m E1 - J ax
extremitats	n	ax k s - t r ax - m i - t a1 t s
extres	n	E1 k s - t r ax s
extruït	n	E k s - t r u - i1 t
fabra	n	f a1 - B r ax
faccions	n	f ax k - s i - o1 n s
fàcilment	n	f a - s i l - m e1 n
facturació	n	f ax k - t u - r ax - s i - o1
factura	n	f ax k - t u1 - r ax
fada	n	f a1 - D ax
fades	n	f a1 - D ax s
fàdua	n	f a1 - D u - ax
falanges	n	f ax - l a1 n - Z ax s
falcons	n	f ax l - k o1 n s
faldiller	n	f ax l - d i - L e1
faldons	n	f ax l - d o1 n s
fallarà	n	f ax - L ax - r a1
fallar	n	f ax - L a1
fallava	n	f ax - L a1 - B ax
falset	n	f ax l - s E1 t
falsificar	n	f ax l - s i - f i - k a1
familiaritzat	n	f ax - m i - l i - ax - r i d - z a1 t
fanta	n	f a1 n - t ax
fantasia	n	f ax n - t ax - z i1 - ax
fantàsica	n	f ax n - t a1 - z i - k ax
fantasies	n	f ax n - t ax - z i1 - ax s
fantasiós	n	f ax n - t ax - z i - o1 s
fantàstica	n	f ax n - t a1 s - t i - k ax
fantàstic	n	f ax n - t a1 s - t i k
farallons	n	f ax - r ax - L o1 n s
farcit	n	f ax rr - s i1 t
farigola	n	f ax - r i - G o1 - l ax
farigoles	n	f ax - r i - G O1 - l ax s
farina	n	f ax - r i1 - n ax
farmàcia	n	f ax rr - m a1 - s i - ax
farmacogenètica	n	f ax rr - m ax - k u - Z ax - n E1 - t i - k ax
farners	n	f ax rr - n e1 s
farta	n	f a1 rr - t ax
fart	n	f a1 rr t
fascicles	n	f ax - s i1 - k l ax s
fascina	n	f ax - s i1 - n ax
fascinat	n	f ax - s i - n a1 t
fàstic	n	f a1 s - t i k
fastigosa	n	f ax s - t i - G o1 - z ax
fastigós	n	f ax s - t i - G o1 s
fastigosos	n	f ax s - t i - G o1 - z u s
fatiga	n	f ax - t i1 - G ax
fatxendes	n	f ax t - S e1 n - d ax s
fauna	n	f a1 uw - n ax
faunístic	n	f ax uw - n i1 s - t i k
favorablement	n	f ax - B u - r a b - b l ax - m e1 n
fax	n	f a1 k s
federació	n	f ax - D ax - r ax - s i - o1
federal	n	f ax - D ax - r a1 l
federalisme	n	f ax - D ax - r ax - l i1 z - m ax
feixuga	n	f ax - S u1 - G ax
feldspat	n	f ax l ts - p a1 t
felicitar	n	f ax - l i - s i - t a1
fèlids	n	f E1 - l i t s
felip	n	f ax - l i1 p
feliu	n	f ax - l i1 uw
fèlix	n	f E1 - l i k s
femella	n	f ax - m e1 - L ax
femelles	n	f ax - m e1 - L ax s
fèmur	n	f E1 - m u rr
fen	n	f e1 n
fenícia	n	f ax - n i1 - s i - ax
fenicis	n	f ax - n i1 - s i s
feredat	n	f ax - r ax - D a1 t
feréstega	n	f ax - r e1 s - t ax - G ax
ferir	n	f ax - r i1
fermament	n	f E rr - m ax - m e1 n
fernández	n	f ax rr - n a1 n - d ax s
feroç	n	f ax - r O1 s
ferotge	n	f ax - r O1 d - Z ax
ferran	n	f ax - rr a1 n
ferrats	n	f ax - rr a1 t s
ferrera	n	f ax - rr e1 - r ax
ferrocarrils	n	f ax - rr u - k ax - rr i1 l s
ferroviària	n	f ax - rr u - B i - a1 - r i - ax
ferventment	n	f ax r - B e m - m e1 n
fessiu	n	f ax - s i1 uw
festival	n	f ax s - t i - B a1 l
festivals	n	f ax s - t i - B a1 l s
fetus	n	f E1 - t u s
feudalisme	n	f ax uw - D ax - l i1 z - m ax
fiabilitat	n	f i - ax - B i - l i - t a1 t
fiable	n	f i - a1 b - b l ax
fiasco	n	f i - a1 s - k u
fiblada	n	f i b - b l a1 - D ax
fibrilant	n	f i - B r i - l a1 n
ficció	n	f i k - s i - o1
fidencià	n	f i - D ax n - s i - a1
figueres	n	f i - G e1 - r ax s
figuretes	n	f i - G u - r E1 - t ax s
filardó	n	f i - l ax r - D o1
filera	n	f i - l e1 - r ax
fileres	n	f i - l e1 - r ax s
filet	n	f i - l E1 t
filferro	n	f i l - f E1 - rr u
filites	n	f i - l i1 - t ax s
filmació	n	f i l - m ax - s i - o1
films	n	f i1 l m s
filòloga	n	f i - l O1 - l u - G ax
filosofal	n	f i - l u - z u - f a1 l
filòsof	n	f i - l O1 - z u f
filosòfic	n	f i - l u - z O1 - f i k
filosòfics	n	f i - l u - z O1 - f i k s
filòsofs	n	f i - l O1 - z u f s
filtraven	n	f i l - t r a1 - B ax n
filtre	n	f i1 l - t r ax
filtres	n	f i1 l - t r ax s
finalització	n	f i - n ax - l i d - z ax - s i - o1
finalitzada	n	f i - n ax - l i d - z a1 - D ax
finalitza	n	f i - n ax - l i1 d - z ax
finalitzar	n	f i - n ax - l i d - z a1
finalitzat	n	f i - n ax - l i d - z a1 t
finalitzen	n	f i - n ax - l i1 d - z ax n
finalment	n	f i - n a l - m e1 n
finançar	n	f i - n ax n - s a1
finestreta	n	f i - n ax s - t r E1 - t ax
finestró	n	f i - n ax s - t r o1
finetes	n	f i - n E1 - t ax s
fingir	n	f i n - Z i1
finley	n	f i n - l E1 j
firmaran	n	f i rr - m ax - r a1 n
firmar	n	f i rr - m a1
fiscal	n	f i s - k a1 l
fiscalia	n	f i s - k ax - l i1 - ax
fiscalitat	n	f i s - k ax - l i - t a1 t
fiscals	n	f i s - k a1 l s
fischler	n	f i s - k l e1
físicament	n	f i - z i - k ax - m e1 n
fisiòleg	n	f i - z i - O1 - l ax k
fitar	n	f i - t a1
fitxa	n	f i1 t - S ax
fitxer	n	f i t - S e1
fitxers	n	f i t - S e1 s
fitxes	n	f i1 t - S ax s
fixament	n	f i k - s ax - m e1 n
fixe	n	f i1 - S ax
flaire	n	f l a1 j - r ax
flaixos	n	f l a1 - S u s
flamenca	n	f l ax - m E1 N - k ax
flaquejar	n	f l ax - k ax - Z a1
flauta	n	f l a1 uw - t ax
flebitis	n	f l ax - B i1 - t i s
fleca	n	f l E1 - k ax
fletxa	n	f l e1 t - S ax
fletxes	n	f l e1 t - S ax s
flexibilitat	n	f l ax k - s i - B i - l i - t a1 t
flexible	n	f l ax k - s i1 b - b l ax
floraina	n	f l u - r a1 j - n ax
floreta	n	f l u - r E1 - t ax
floretes	n	f l u - r E1 - t ax s
floringuelles	n	f l u - r i N - g e1 - L ax s
flotador	n	f l u - t ax - D o1
flotar	n	f l u - t a1
fluida	n	f l u1 j - D ax
fluïdesa	n	f l u - i - D E1 - z ax
fluir	n	f l u - i1
fluixesa	n	f l u - S E1 - z ax
fluvià	n	f l u - B i - a1
fogonet	n	f u - G u - n E1 t
foguera	n	f u - G e1 - r ax
folklore	n	f u l - k l O1 - r ax
foll	n	f o1 L
folre	n	f o1 l - rr ax
fonedissos	n	f u - n ax - D i1 - s u s
fongs	n	f o1 N s
fònics	n	f O1 - n i k s
fonològic	n	f u - n u - l O1 - Z i k
fontmartina	n	f u n - m ax rr - t i1 - n ax
foques	n	f o1 - k ax s
foradades	n	f u - r ax - D a1 - D ax s
foradat	n	f u - r ax - D a1 t
forçosament	n	f u rr - s o - z ax - m e1 n
formalitzar	n	f u rr - m ax - l i d - z a1
formiguer	n	f u rr - m i - G e1
formoses	n	f u rr - m o1 - z ax s
fornera	n	f u rr - n e1 - r ax
forner	n	f u rr - n e1
fortalesa	n	f u rr - t ax - l E1 - z ax
fortament	n	f O rr - t ax - m e1 n
fortificats	n	f u rr - t i - f i - k a1 t s
fortor	n	f u rr - t o1
fòrum	n	f O1 - r u m
fòrums	n	f O1 - r u m s
foscor	n	f u s - k o1
fosqueja	n	f u s - k E1 - Z ax
fossar	n	f u - s a1
fossilífers	n	f u - s i - l i1 - f ax s
fòssils	n	f O1 - s i l s
fotem	n	f u - t E1 m
fotent	n	f u - t e1 n
foteses	n	f u - t E1 - z ax s
fotocòpia	n	f u - t u - k O1 - p i - ax
fotocòpies	n	f u - t u - k O1 - p i - ax s
fotògraf	n	f u - t O1 - G r ax f
fotògrafs	n	f u - t O1 - G r ax f s
fotran	n	f u - t r a1 n
fotries	n	f u - t r i1 - ax s
fractal	n	f r ax k - t a1 l
fractures	n	f r ax k - t u1 - r ax s
fra	n	f r a1
fraga	n	f r a1 - G ax
fragmentació	n	f r ax g - m ax n - t ax - s i - o1
frança	n	f r a1 n - s ax
francesc	n	f r ax n - s E1 s k
franciscà	n	f r ax n - s i s - k a1
franctirador	n	f r a N - t i - r ax - D o1
frankfurt	n	f r ax N k - f u1 rr t
franquisme	n	f r ax N - k i1 z - m ax
fratricidi	n	f r ax - t r i - s i1 - D i
frausa	n	f r a1 uw - z ax
frec	n	f r E1 k
fredor	n	f r ax - D o1
frenètic	n	f r ax - n E1 - t i k
frens	n	f r E1 n s
freqüentava	n	f r ax - k w ax n - t a1 - B ax
freqüentment	n	f r ax - k w e m - m e1 n
frescor	n	f r ax s - k o1
frescosa	n	f r ax s - k o1 - z ax
fresquets	n	f r ax s - k E1 t s
frip	n	f r i1 p
frisosos	n	f r i - z o1 - z u s
frívoles	n	f r i1 - B u - l ax s
frivolitat	n	f r i - B u - l i - t a1 t
frondós	n	f r u n - d o1 s
frontó	n	f r u n - t o1
frustrats	n	f r u s - t r a1 t s
frustrava	n	f r u s - t r a1 - B ax
fuetejada	n	f u - ax - t ax - Z a1 - D ax
fuet	n	f u - E1 t
fugaç	n	f u - G a1 s
fuga	n	f u1 - G ax
fuita	n	f u1 j - t ax
fullejant	n	f u - L ax - Z a1 n
funcionalitat	n	f u n - s i - u - n ax - l i - t a1 t
funeral	n	f u - n ax - r a1 l
furgoneta	n	f u r - G u - n E1 - t ax
furgonetes	n	f u r - G u - n E1 - t ax s
fusteta	n	f u s - t E1 - t ax
futbol	n	f u b - b O1 l
futbolí	n	f u b - b u - l i1
futurista	n	f u - t u - r i1 s - t ax
gabriel	n	g ax - B r i - E1 l
gaditans	n	g ax - D i - t a1 n s
gaèliques	n	g ax - E1 - l i - k ax s
gaià	n	g ax - y a1
gairell	n	g ax j - r e1 L
gala	n	g a1 - l ax
galàxies	n	g ax - l a1 k - s i - ax s
gales	n	g a1 - l ax s
galetes	n	g ax - l E1 - t ax s
galícia	n	g ax - l i1 - s i - ax
gallega	n	g ax - L E1 - G ax
gamma	n	g a1 m - m ax
gamper	n	g ax m - p e1
gandesa	n	g ax n - d E1 - z ax
ganduls	n	g ax n - d u1 l s
gàngsters	n	g a1 N s - t ax rr s
gante	n	g a1 n - t ax
ganxos	n	g a1 n - S u s
ganyota	n	g ax - J O1 - t ax
ganyotes	n	g ax - J O1 - t ax s
ganz	n	g a1 n s
garapinyades	n	g ax - r ax - p i - J a1 - D ax s
garatges	n	g ax - r a1 d - Z ax s
gargallons	n	g ax r - G ax - L o1 n s
gargot	n	g ax r - G O1 t
garona	n	g ax - r o1 - n ax
garrafes	n	g ax - rr a1 - f ax s
garraf	n	g ax - rr a1 f
garratibats	n	g ax - rr ax - t i - B a1 t s
garriga	n	g ax - rr i1 - G ax
garrigues	n	g ax - rr i1 - G ax s
garrotxa	n	g ax - rr O1 t - S ax
garses	n	g a1 rr - s ax s
gasoil	n	g ax - z O1 j l
gasol	n	g ax - z O1 l
gasolina	n	g ax - z u - l i1 - n ax
gasolinera	n	g ax - z u - l i - n e1 - r ax
gaspart	n	g ax s - p a1 rr t
gaspatxo	n	g ax s - p a1 t - S u
gasta	n	g a1 s - t ax
gasteròpodes	n	g ax s - t ax - r O1 - p u - D ax s
gastronomia	n	g ax s - t r u - n u - m i1 - ax
gastronòmica	n	g ax s - t r u - n O1 - m i - k ax
gatets	n	g ax - t E1 t s
gavà	n	g ax - B a1
gavarres	n	g ax - B a1 - rr ax s
gavines	n	g ax - B i1 - n ax s
gelada	n	Z ax - l a1 - D ax
gelida	n	Z ax - l i1 - D ax
gèlida	n	Z E1 - l i - D ax
gelor	n	Z ax - l o1
geltrú	n	Z ax l - t r u1
gemecs	n	Z ax - m e1 k s
gemec	n	Z ax - m e1 k
gemma	n	Z e1 m - m ax
generalíssim	n	Z ax - n ax - r ax - l i1 - s i m
genets	n	Z ax - n E1 t s
genocidi	n	Z ax - n u - s i1 - D i
geoeconòmics	n	Z e - u - ax - k u - n O1 - m i k s
geògraf	n	Z ax - O1 - G r ax f
geometria	n	Z ax - u - m ax - t r i1 - ax
gerard	n	Z ax - r a1 rr t
gerent	n	Z ax - r e1 n
geriàtrics	n	Z ax - r i - a1 - t r i k s
germanastres	n	Z ax rr - m ax - n a1 s - t r ax s
germanor	n	Z ax rr - m ax - n o1
gerom	n	Z ax - r o1 m
gespa	n	Z e1 s - p ax
gesta	n	Z e1 s - t ax
gesticulacions	n	Z ax s - t i - k u - l ax - s i - o1 n s
gesticulant	n	Z ax s - t i - k u - l a1 n
gesticular	n	Z ax s - t i - k u - l a1
gestionarà	n	Z ax s - t i - u - n ax - r a1
gestionar	n	Z ax s - t i - u - n a1
gestionat	n	Z ax s - t i - u - n a1 t
gestiona	n	Z ax s - t i - o1 - n ax
gestioneu	n	Z ax s - t i - u - n E1 uw
gestor	n	Z ax s - t o1
gestuals	n	Z ax s - t u - a1 l s
gimnasta	n	Z i m - n a1 s - t ax
ginebra	n	Z i - n e1 - B r ax
girafes	n	Z i - r a1 - f ax s
giravoltar	n	Z i - r ax - B u l - t a1
girona	n	Z i - r o1 - n ax
gironès	n	Z i - r u - n E1 s
gironines	n	Z i - r u - n i1 - n ax s
gir	n	Z i1 rr
gitanjali	n	Z i - t ax n - Z a1 - l i
gitanos	n	Z i - t a1 - n u s
glasgow	n	g l ax z - G o1 B
globalment	n	g l u - B a l - m e1 n
glòbuls	n	g l O1 - B u l s
globus	n	g l O1 - B u s
glossaris	n	g l u - s a1 - r i s
gneissificació	n	g n ax j - s i - f i - k ax - s i - o1
gog	n	g O1 k
gola	n	g o1 - l ax
goles	n	g o1 - l ax s
golfes	n	g o1 l - f ax s
golf	n	g O1 l f
golfo	n	g o1 l - f u
goma	n	g o1 - m ax
goniòmetres	n	g u - n i - O1 - m ax - t r ax s
gonzález	n	g u n - z a1 - l ax s
goril·les	n	g u - r i1 - l ax s
gorina	n	g u - r i1 - n ax
gorra	n	g O1 - rr ax
gossera	n	g u - s e1 - r ax
gots	n	g O1 t s
gràcil	n	g r a1 - s i l
gradació	n	g r ax - D ax - s i - o1
gradin	n	g r a1 - D i n
graella	n	g r ax - e1 - L ax
gramola	n	g r ax - m O1 - l ax
granada	n	g r ax - n a1 - D ax
grandària	n	g r ax n - d a1 - r i - ax
grandeta	n	g r ax n - d E1 - t ax
grand	n	g r a1 n
grandiosa	n	g r ax n - d i - o1 - z ax
granet	n	g r ax - n E1 t
granger	n	g r ax n - Z e1
granges	n	g r a1 n - Z ax s
granit	n	g r ax - n i1 t
granja	n	g r a1 n - Z ax
granollers	n	g r ax - n u - L e1 s
granota	n	g r ax - n O1 - t ax
granotes	n	g r ax - n O1 - t ax s
granulometria	n	g r ax - n u - l u - m ax - t r i1 - ax
grapat	n	g r ax - p a1 t
graset	n	g r ax - z E1 t
gratant	n	g r ax - t a1 n
grat	n	g r a1 t
gratificant	n	g r ax - t i - f i - k a1 n
gratinat	n	g r ax - t i - n a1 t
gratuïtament	n	g r ax - t u - i - t ax - m e1 n
graux	n	g r a1 uw k s
gravada	n	g r ax - B a1 - D ax
gravades	n	g r ax - B a1 - D ax s
gravarem	n	g r ax - B ax - r E1 m
gravar	n	g r ax - B a1
gravat	n	g r ax - B a1 t
gravats	n	g r ax - B a1 t s
grècia	n	g r E1 - s i - ax
gregori	n	g r ax - G O1 - r i
greix	n	g r e1 S
greixos	n	g r e1 - S u s
greixós	n	g r ax - S o1 s
gremial	n	g r ax - m i - a1 l
gremis	n	g r E1 - m i s
greuge	n	g r e1 uw - Z ax
grill	n	g r i1 L
grills	n	g r i1 L s
grinyola	n	g r i - J O1 - l ax
grinyolaven	n	g r i - J u - l a1 - B ax n
grinyolen	n	g r i - J O1 - l ax n
gripaus	n	g r i - p a1 uw s
grisosos	n	g r i - z o1 - z u s
groenlàndia	n	g r u - ax n - l a1 n - d i - ax
grog	n	g r O1 k
grogosos	n	g r u - G o1 - z u s
groguenc	n	g r u - G E1 N
grollera	n	g r u - L e1 - r ax
gronxador	n	g r u n - S ax - D o1
gronxadors	n	g r u n - S ax - D o1 s
grotesc	n	g r u - t E1 s k
grua	n	g r u1 - ax
grupet	n	g r u - p E1 t
grupets	n	g r u - p E1 t s
gruta	n	g r u1 - t ax
guaita	n	g w a1 j - t ax
guanyador	n	g w ax - J ax - D o1
guard	n	g w a1 rr t
guardians	n	g w ax r - D i - a1 n s
guatlles	n	g w a1 L - L ax s
güell	n	g w e1 L
guerreres	n	g ax - rr e1 - r ax s
guerrer	n	g ax - rr e1
guerrers	n	g ax - rr e1 s
guerxos	n	g E1 rr - S u s
guetos	n	g e1 - t u s
guillem	n	g i - L E1 m
guinda	n	g i1 n - d ax
guinguetes	n	g i N - g E1 - t ax s
guió	n	g i - o1
guionista	n	g i - u - n i1 s - t ax
guipúscoa	n	g i - p u1 s - k u - ax
guipuscoanes	n	g i - p u s - k u - a1 - n ax s
guirigall	n	g i - r i - G a1 L
guitarra	n	g i - t a1 - rr ax
guitarres	n	g i - t a1 - rr ax s
guixada	n	g i - S a1 - D ax
guixat	n	g i - S a1 t
guixats	n	g i - S a1 t s
guíxols	n	g i1 k - s u l s
guixots	n	g i - S O1 t s
günther	n	g w n t e1 rr
guspira	n	g u s - p i1 - r ax
guspires	n	g u s - p i1 - r ax s
habilita	n	ax - B i - l i1 - t ax
habilitarà	n	ax - B i - l i - t ax - r a1
habiliteu	n	ax - B i - l i - t E1 uw
habitualment	n	ax - B i - t u - a l - m e1 n
haguessiu	n	ax - G ax - s i1 uw
haia	n	a1 - y ax
halo	n	a1 - l u
hansen	n	a1 n - s ax n
harmònica	n	ax rr - m O1 - n i - k ax
harmonioses	n	ax rr - m u - n i - o1 - z ax s
harmonitza	n	ax rr - m u - n i1 d - z ax
hebron	n	ax - B r o1 n
hectòmetres	n	ax k - t O1 - m ax - t r ax s
heidi	n	E1 j - D i
hemorràgia	n	ax - m u - rr a1 - Z i - ax
henna	n	e1 n - n ax
herbívor	n	ax r - B i1 - B u rr
heroïcitat	n	ax - r u - i - s i - t a1 t
heterosexuals	n	e - t ax - r u - s ax k - s u - a1 l s
heteròtrofa	n	ax - t ax - r O1 - t r u - f ax
híbrid	n	i1 - B r i t
higiene	n	i - Z i - E1 - n ax
himne	n	i1 m - n ax
himnes	n	i1 m - n ax s
hipnotitzant	n	i b - n u - t i d - z a1 n
hipnotitza	n	i b - n u - t i1 d - z ax
hipòcrita	n	i - p O1 - k r i - t ax
hipòdrom	n	i - p O1 - D r u m
hipoteques	n	i - p u - t E1 - k ax s
hippie	n	i p - p i1 - ax
histèrics	n	i s - t E1 - r i k s
histograma	n	i s - t u - G r a1 - m ax
historial	n	i s - t u - r i - a1 l
historietes	n	i s - t u - r i - E1 - t ax s
hivernació	n	i - B ax rr - n ax - s i - o1
hivernacle	n	i - B ax rr - n a1 - k l ax
hivernar	n	i - B ax rr - n a1
homenots	n	u - m ax - n O1 t s
homonímia	n	u - m u - n i1 - m i - ax
homo	n	o1 - m u
honest	n	u - n e1 s t
hongaresos	n	u N - g ax - r E1 - z u s
honoraris	n	u - n u - r a1 - r i s
horària	n	u - r a1 - r i - ax
horàris	n	u - r a1 - r i s
horaris	n	u - r a1 - r i s
horrible	n	u - rr i1 b - b l ax
horroroses	n	u - rr u - r o1 - z ax s
hortet	n	u rr - t E1 t
hospitalet	n	u s - p i - t ax - l E1 t
hostal	n	u s - t a1 l
hostesses	n	u s - t E1 - s ax s
hoste	n	O1 s - t ax
hòstia	n	O1 s - t i - ax
hotelera	n	u - t ax - l e1 - r ax
hoteler	n	u - t ax - l e1
houston	n	o uw s - t o1 n
huelva	n	w E1 l - B ax
hug	n	u1 k
humorista	n	u - m u - r i1 s - t ax
humorística	n	u - m u - r i1 s - t i - k ax
iaia	n	y a1 - y ax
iaio	n	y a1 - y u
ianquis	n	y a1 N - k i s
ibarretxe	n	i - B ax - rr e1 t - S ax
iberoamericana	n	i - B ax - r u - ax - m ax - r i - k a1 - n ax
icar	n	i - k a1
icart	n	i - k a1 rr t
icona	n	i - k o1 - n ax
icones	n	i - k o1 - n ax s
idealitzen	n	i - D e - ax - l i1 d - z ax n
idear	n	i - D e - a1
ideat	n	i - D e - a1 t
identificatives	n	i - D ax n - t i - f i - k ax - t i1 - B ax s
ideològicament	n	i - D ax - u - l O - Z i - k ax - m e1 n
ideologista	n	i - D e - u - l u - Z i1 s - t ax
idolatraven	n	i - D u - l ax - t r a1 - B ax n
idoneïtat	n	i - D u - n ax - i - t a1 t
idoni	n	i - D O1 - n i
iemenites	n	y ax - m ax - n i1 - t ax s
iens	n	y E1 n s
ignasi	n	i g - n a1 - z i
ígnia	n	i1 g - n i - ax
igualació	n	i - G w ax - l ax - s i - o1
igualada	n	i - G w ax - l a1 - D ax
igualar	n	i - G w ax - l a1
igualitaris	n	i - G w ax - l i - t a1 - r i s
igualment	n	i - G w a l - m e1 n
il·legal	n	i - l ax - G a1 l
il·legals	n	i - l ax - G a1 l s
il·limitades	n	i - l i - m i - t a1 - D ax s
il·lusionada	n	i - l u - z i - u - n a1 - D ax
il·lusionat	n	i - l u - z i - u - n a1 t
il·lusori	n	i - l u - z O1 - r i
il·lustre	n	i - l u1 s - t r ax
imaginables	n	i - m ax - Z i - n a1 b - b l ax s
imbevible	n	i m - b ax - B i1 b - b l ax
immadur	n	i m - m ax - D u1
imma	n	i1 m - m ax
immaterial	n	i m - m ax - t ax - r i - a1 l
immediatament	n	i m - m ax - D i - a - t ax - m e1 n
immensament	n	i m - m E n - s ax - m e1 n
immers	n	i m - m E1 rr s
immersió	n	i m - m ax rr - s i - o1
imminentment	n	i m - m i - n e m - m e1 n
immobiliàries	n	i m - m u - B i - l i - a1 - r i - ax s
immobiliari	n	i m - m u - B i - l i - a1 - r i
immoble	n	i m - m O1 b - b l ax
immobles	n	i m - m O1 b - b l ax s
immortalitzava	n	i m - m u rr - t ax - l i d - z a1 - B ax
immunodeficiència	n	i m - m u - n u - D ax - f i - s i - E1 n - s i - ax
immutable	n	i m - m u - t a1 b - b l ax
immutàrem	n	i m - m u - t a1 - r ax m
impaciència	n	i m - p ax - s i - E1 n - s i - ax
impacient	n	i m - p ax - s i - e1 n
impacta	n	i m - p a1 k - t ax
imparable	n	i m - p ax - r a1 b - b l ax
impartir	n	i m - p ax rr - t i1
impecablement	n	i m - p ax - k a b - b l ax - m e1 n
impediments	n	i m - p ax - D i - m e1 n s
impenetrable	n	i m - p ax - n ax - t r a1 b - b l ax
imperava	n	i m - p ax - r a1 - B ax
imperfecte	n	i m - p ax rr - f e1 k - t ax
impermeabilització	n	i m - p ax rr - m e - ax - B i - l i d - z ax - s i - o1
impermeables	n	i m - p ax rr - m e - a1 b - b l ax s
implantar	n	i m - p l ax n - t a1
implementa	n	i m - p l ax - m e1 n - t ax
importadores	n	i m - p u rr - t ax - D o1 - r ax s
impotència	n	i m - p u - t E1 n - s i - ax
impregnaven	n	i m - p r ax g - n a1 - B ax n
impressionants	n	i m - p r ax - s i - u - n a1 n s
impressionista	n	i m - p r ax - s i - u - n i1 s - t ax
impressora	n	i m - p r ax - s o1 - r ax
impressores	n	i m - p r ax - s o1 - r ax s
imprevisible	n	i m - p r ax - B i - z i1 b - b l ax
improbable	n	i m - p r u - B a1 b - b l ax
improcedent	n	i m - p r u - s ax - D e1 n
impulsivament	n	i m - p u l - s i - B ax - m e1 n
impunes	n	i m - p u1 - n ax s
inacabable	n	i - n ax - k ax - B a1 b - b l ax
inacabada	n	i - n ax - k ax - B a1 - D ax
inactiu	n	i - n ax k - t i1 uw
inapreciable	n	i - n ax - p r ax - s i - a1 b - b l ax
inauguràrem	n	i - n ax uw - G u - r a1 - r ax m
inaugurar	n	i - n ax uw - G u - r a1
inca	n	i1 N - k ax
incansable	n	i N - k ax n - s a1 b - b l ax
incendiaren	n	i n - s ax n - d i - a1 - r ax n
incentiu	n	i n - s ax n - t i1 uw
incidents	n	i n - s i - D e1 n s
incitava	n	i n - s i - t a1 - B ax
incívica	n	i n - s i1 - B i - k ax
incívic	n	i n - s i1 - B i k
incivisme	n	i n - s i - B i1 z - m ax
inclinar	n	i N - k l i - n a1
inclusió	n	i N - k l u - z i - o1
incògnit	n	i N - k O1 g - n i t
incoherents	n	i N - k u - ax - r e1 n s
incòmoda	n	i N - k O1 - m u - D ax
incomoda	n	i N - k u - m O1 - D ax
incòmode	n	i N - k O1 - m u - D ax
incomoditat	n	i N - k u - m u - D i - t a1 t
incompatibilitats	n	i N - k u m - p ax - t i - B i - l i - t a1 t s
incompleta	n	i N - k u m - p l E1 - t ax
incomprensió	n	i N - k u m - p r ax n - s i - o1
inconscientment	n	i N - k u n - s i - e m - m e1 n
inconsistència	n	i N - k u n - s i s - t E1 n - s i - ax
incontrolable	n	i N - k u n - t r u - l a1 b - b l ax
incorregible	n	i N - k u - rr ax - Z i1 b - b l ax
incrèdul	n	i N - k r E1 - D u l
incredulitat	n	i N - k r ax - D u - l i - t a1 t
increïble	n	i N - k r ax - i1 b - b l ax
incremental	n	i N - k r ax - m ax n - t a1 l
incrustacions	n	i N - k r u s - t ax - s i - o1 n s
incrustat	n	i N - k r u s - t a1 t
incrustats	n	i N - k r u s - t a1 t s
incubació	n	i N - k u - B ax - s i - o1
inculta	n	i N - k u1 l - t ax
incursions	n	i N - k u rr - s i - o1 n s
indagacions	n	i n - d ax - G ax - s i - o1 n s
indecisa	n	i n - d ax - s i1 - z ax
indefinit	n	i n - d ax - f i - n i1 t
indeguts	n	i n - d ax - G u1 t s
independitzar	n	i n - d ax - p ax n - d i d - z a1
indescriptible	n	i n - d ax s - k r i p - t i1 b - b l ax
indesitjables	n	i n - d ax - z i d - Z a1 b - b l ax s
indexació	n	i n - d ax k - s ax - s i - o1
indexa	n	i n - d e1 k - s ax
Índia	n	i1 n - d i - ax
índic	n	i1 n - d i k
indi	n	i1 n - d i
individualista	n	i n - d i - B i - D u - ax - l i1 s - t ax
individualitzada	n	i n - d i - B i - D u - ax - l i d - z a1 - D ax
individualment	n	i n - d i - B i - D u - a l - m e1 n
indolència	n	i n - d u - l E1 n - s i - ax
indòmita	n	i n - d O1 - m i - t ax
inducció	n	i n - d u k - s i - o1
indumentària	n	i n - d u - m ax n - t a1 - r i - ax
ineficàcia	n	i - n ax - f i - k a1 - s i - ax
inesperada	n	i - n ax s - p ax - r a1 - D ax
inevitablement	n	i - n ax - B i - t a b - b l ax - m e1 n
inexactes	n	i - n ax g - z a1 k - t ax s
inexorablement	n	i - n ax g - z u - r a b - b l ax - m e1 n
inexplicablement	n	i - n ax k s - p l i - k a b - b l ax - m e1 n
inexpressiva	n	i - n ax k s - p r ax - s i1 - B ax
infàmies	n	i m - f a1 - m i - ax s
infidel	n	i m - f i - D E1 l
infidels	n	i m - f i - D E1 l s
infinites	n	i m - f i - n i1 - t ax s
inflada	n	i m - f l a1 - D ax
inflamable	n	i m - f l ax - m a1 b - b l ax
inflamatòria	n	i m - f l ax - m ax - t O1 - r i - ax
inflar	n	i m - f l a1
inflexibles	n	i m - f l ax k - s i1 b - b l ax s
infligir	n	i m - f l i - Z i1
info	n	i1 m - f u
informàtica	n	i m - f u rr - m a1 - t i - k ax
informàtic	n	i m - f u rr - m a1 - t i k
informàtics	n	i m - f u rr - m a1 - t i k s
infraccions	n	i m - f r ax k - s i - o1 n s
infraestructura	n	i m - f r ax s - t r u k - t u1 - r ax
infrarojos	n	i m - f r ax - rr O1 - Z u s
infringit	n	i m - f r i n - Z i1 t
infusió	n	i m - f u - z i - o1
ingerit	n	i n - Z ax - r i1 t
ingràvid	n	i N - g r a1 - B i t
ingressar	n	i N - g r ax - s a1
ingressats	n	i N - g r ax - s a1 t s
ingresses	n	i N - g r e1 - s ax s
inhabilita	n	i - n ax - B i - l i1 - t ax
inhabilitaria	n	i - n ax - B i - l i - t ax - r i1 - ax
inhabilitar	n	i - n ax - B i - l i - t a1
inhalo	n	i - n a1 - l u
inicialitzar	n	i - n i - s i - ax - l i d - z a1
iniciàtics	n	i - n i - s i - a1 - t i k s
injusta	n	i n - Z u1 s - t ax
injustícia	n	i n - Z u s - t i1 - s i - ax
inna	n	i1 n - n ax
innocència	n	i n - n u - s E1 n - s i - ax
innovadores	n	i n - n u - B ax - D o1 - r ax s
inoblidable	n	i - n u - B l i - D a1 b - b l ax
inoportunes	n	i - n u - p u rr - t u1 - n ax s
inquiet	n	i N - k i - e1 t
inrevés	n	i n - rr ax - B e1 s
insalvable	n	i n - s ax l - B a1 b - b l ax
insatisfacció	n	i n - s ax - t i s - f ax k - s i - o1
insatisfeta	n	i n - s ax - t i s - f e1 - t ax
insatisfets	n	i n - s ax - t i s - f e1 t s
insectes	n	i n - s e1 k - t ax s
insectívor	n	i n - s ax k - t i1 - B u rr
insegura	n	i n - s ax - G u1 - r ax
insegur	n	i n - s ax - G u1
inseminació	n	i n - s ax - m i - n ax - s i - o1
insistentment	n	i n - s i s - t e m - m e1 n
insofrible	n	i n - s u - f r i1 b - b l ax
insolència	n	i n - s u - l E1 n - s i - ax
insomni	n	i n - s O1 m - n i
inspector	n	i n s - p ax k - t o1
inspiració	n	i n s - p i - r ax - s i - o1
instantània	n	i n s - t ax n - t a1 - n i - ax
instantanis	n	i n s - t ax n - t a1 - n i s
instintivament	n	i n s - t i n - t i - B ax - m e1 n
instrumental	n	i n s - t r u - m ax n - t a1 l
insulsa	n	i n - s u1 l - s ax
insultar	n	i n - s u l - t a1
insuportable	n	i n - s u - p u rr - t a1 b - b l ax
insurrecció	n	i n - s u - rr ax k - s i - o1
intacta	n	i n - t a1 k - t ax
intactes	n	i n - t a1 k - t ax s
intangible	n	i n - t ax n - Z i1 b - b l ax
integradora	n	i n - t ax - G r ax - D o1 - r ax
íntegra	n	i1 n - t ax - G r ax
íntegrament	n	i n - t ax - G r ax - m e1 n
integrants	n	i n - t ax - G r a1 n s
intencionats	n	i n - t ax n - s i - u - n a1 t s
intensament	n	i n - t E n - s ax - m e1 n
interaccionar	n	i n - t ax - r ax k - s i - u - n a1
intercranial	n	i n - t ax rr - k r ax - n i - a1 l
interdisciplinàri	n	i n - t ax r - D i - s i - p l i - n a1 - r i
interfície	n	i n - t ax rr - f i1 - s i - ax
intermediari	n	i n - t ax rr - m ax - D i - a1 - r i
internautes	n	i n - t ax rr - n a1 uw - t ax s
internet	n	i n - t ax rr - n E1 t
interrogant	n	i n - t ax - rr u - G a1 n
intervals	n	i n - t ax r - B a1 l s
íntimament	n	i n - t i - m ax - m e1 n
intimidada	n	i n - t i - m i - D a1 - D ax
intimidar	n	i n - t i - m i - D a1
intranquil·les	n	i n - t r ax N - k i1 - l ax s
intranquil·litat	n	i n - t r ax N - k i - l i - t a1 t
intranscendent	n	i n - t r ax - s ax n - d e1 n
intraoculars	n	i n - t r ax - u - k u - l a1 rr s
intrigada	n	i n - t r i - G a1 - D ax
intrínsecs	n	i n - t r i1 n - s ax k s
intro	n	i1 n - t r u
intueixo	n	i n - t u - E1 - S u
intuïa	n	i n - t u - i1 - ax
intuir	n	i n - t u - i1
intuït	n	i n - t u - i1 t
intuïtiu	n	i n - t u - i - t i1 uw
inundables	n	i - n u n - d a1 b - b l ax s
invalidesa	n	i m - b ax - l i - D E1 - z ax
inversor	n	i m - b ax rr - s o1
invertit	n	i m - b ax rr - t i1 t
investigar	n	i m - b ax s - t i - G a1
investigui	n	i m - b ax s - t i1 - G i
involuntaris	n	i m - b u - l u n - t a1 - r i s
ioga	n	y O1 - G ax
iogurts	n	y u - G u1 rr s
iogurt	n	y u - G u1 rr t
ionquis	n	y O1 N - k i s
ionqui	n	y O1 N - k i
iot	n	y O1 t
ira	n	i1 - r ax
irgalundra	n	i r - G ax - l u1 n - d r ax
irlanda	n	i rr - l a1 n - d ax
irlandesa	n	i rr - l ax n - d E1 - z ax
ironia	n	i - r u - n i1 - ax
irracionalment	n	i - rr ax - s i - u - n a l - m e1 n
irreal	n	i - rr e - a1 l
irreals	n	i - rr e - a1 l s
irreconeixibles	n	i - rr ax - k u - n ax - S i1 b - b l ax s
irrefutable	n	i - rr ax - f u - t a1 b - b l ax
irrellevant	n	i - rr ax - L ax - B a1 n
irremeiablement	n	i - rr ax - m ax - y a b - b l ax - m e1 n
irrepetibles	n	i - rr ax - p ax - t i1 b - b l ax s
irrompre	n	i - rr o1 m - p r ax
irrupció	n	i - rr u p - s i - o1
islamabad	n	i z - l ax - m ax - B a1 t
islàmica	n	i z - l a1 - m i - k ax
islam	n	i z - l a1 m
islàndia	n	i z - l a1 n - d i - ax
israelià	n	i z - rr ax - e - l i - a1
istiu	n	i s - t i1 uw
itàlia	n	i - t a1 - l i - ax
ítems	n	i1 - t ax m s
itinerants	n	i - t i - n ax - r a1 n s
itinerari	n	i - t i - n ax - r a1 - r i
iugoslàvia	n	y u - G u z - l a1 - B i - ax
iva	n	i1 - B ax
íxia	n	i1 k - s i - ax
jaén	n	Z ax - e1 n
jamaicans	n	Z ax - m ax j - k a1 n s
jamaica	n	Z ax - m a1 j - k ax
jamaicà	n	Z ax - m ax j - k a1
jaqueta	n	Z ax - k E1 - t ax
jardinet	n	Z ax r - D i - n E1 t
jaume	n	Z a1 uw - m ax
jensen	n	Z E1 n - s ax n
jerarquitzar	n	Z ax - r ax rr - k i d - z a1
jeroni	n	Z ax - r O1 - n i
jersei	n	Z ax rr - s E1 j
jerusalem	n	Z ax - r u - z ax - l E1 m
jesuïtes	n	Z ax - z u - i1 - t ax s
jesús	n	Z ax - z u1 s
joan	n	Z u - a1 n
joaquim	n	Z u - ax - k i1 m
joel	n	Z u - E1 l
jofre	n	Z o1 - f r ax
johannesburg	n	Z u - ax n - n ax z - B u1 rr k
joiera	n	Z u - y e1 - r ax
jordània	n	Z u r - D a1 - n i - ax
jordi	n	Z O1 r - D i
josep	n	Z u - z E1 p
jospin	n	Z O1 s - p i n
jota	n	Z O1 - t ax
joveneta	n	Z u - B ax - n E1 - t ax
jovenets	n	Z u - B ax - n E1 t s
jovenet	n	Z u - B ax - n E1 t
jovialitat	n	Z u - B i - ax - l i - t a1 t
jovial	n	Z u - B i - a1 l
jubilació	n	Z u - B i - l ax - s i - o1
jubilada	n	Z u - B i - l a1 - D ax
jueva	n	Z u - e1 - B ax
jugadora	n	Z u - G ax - D o1 - r ax
jugadors	n	Z u - G ax - D o1 s
juganeres	n	Z u - G ax - n e1 - r ax s
juganer	n	Z u - G ax - n e1
júlia	n	Z u1 - l i - ax
juli	n	Z u1 - l i
jurament	n	Z u - r ax - m e1 n
juraria	n	Z u - r ax - r i1 - ax
juràssic	n	Z u - r a1 - s i k
justificants	n	Z u s - t i - f i - k a1 n s
kabul	n	k ax - B u1 l
kafkianes	n	k ax f - k i - a1 - n ax s
kelly	n	k e1 - L i
kenna	n	k e1 n - n ax
kenya	n	k E1 - J ax
kíev	n	k i1 - ax p
kingston	n	k i N s - t o1 n
kinkel	n	k i N - k E1 l
kirsten	n	k i1 rr s - t ax n
kuwaitians	n	k u - B ax j - t i - a1 n s
kuwait	n	k u - B a1 j t
labiades	n	l ax - B i - a1 - D ax s
laboratori	n	l ax - B u - r ax - t O1 - r i
laboratoris	n	l ax - B u - r ax - t O1 - r i s
labor	n	l ax - B o1 rr
lacrimògens	n	l ax - k r i - m O1 - Z ax n s
laia	n	l a1 - y ax
lamentable	n	l ax - m ax n - t a1 b - b l ax
lamenta	n	l ax - m e1 n - t ax
lamento	n	l ax - m e1 n - t u
làmpada	n	l a1 m - p ax - D ax
làmpades	n	l a1 m - p ax - D ax s
lampista	n	l ax m - p i1 s - t ax
langen	n	l a1 n - Z ax n
lanzarote	n	l ax n - z ax - r o1 - t ax
larrea	n	l ax - rr E1 - ax
latino	n	l ax - t i1 - n u
lavabo	n	l ax - B a1 - B u
lavabos	n	l ax - B a1 - B u s
leandre	n	l e - a1 n - d r ax
legalitza	n	l ax - G ax - l i1 d - z ax
legió	n	l ax - Z i - o1
légolas	n	l e1 - G u - l ax s
lègolas	n	l E1 - G u - l ax s
leis	n	l E1 j s
lentament	n	l e n - t ax - m e1 n
lentitud	n	l ax n - t i - t u1 t
leopardi	n	l ax - u - p a1 r - D i
lepra	n	l e1 - p r ax
letònia	n	l ax - t O1 - n i - ax
leucèmia	n	l ax uw - s E1 - m i - ax
lexicosemàntics	n	l ax k - s i - k u - z ax - m a1 n - t i k s
leyla	n	l E1 j - l ax
licita	n	l i - s i1 - t ax
liechtenstein	n	l i - ax k - t E1 n s - t ax j n
lífting	n	l i1 f - t i N
light	n	l i1 G t
liikanen	n	l i j - k a1 - n ax n
lió	n	l i - o1
lírica	n	l i1 - r i - k ax
lisboa	n	l i z - B o1 - ax
lismi	n	l i1 z - m i
literalment	n	l i - t ax - r a l - m e1 n
litigi	n	l i - t i1 - Z i
litosfera	n	l i - t u s - f e1 - r ax
liverpool	n	l i - B ax rr - p u - O1 l
ljubljana	n	l Z u B l - Z a1 - n ax
lladró	n	L ax - D r o1
llagosta	n	L ax - G o1 s - t ax
llambordes	n	L ax m - b O1 r - D ax s
llaminadures	n	L ax - m i - n ax - D u1 - r ax s
llampegar	n	L ax m - p ax - G a1
llanterna	n	L ax n - t E1 rr - n ax
llapis	n	L a1 - p i s
llardosos	n	L ax r - D o1 - z u s
llargada	n	L ax r - G a1 - D ax
llargament	n	L a r - G ax - m e1 n
llargàries	n	L ax r - G a1 - r i - ax s
llargmetratges	n	L a rr g - m ax - t r a1 d - Z ax s
llastima	n	L ax s - t i1 - m ax
llaurar	n	L ax uw - r a1
llebrers	n	L ax - B r e1 s
llefiscós	n	L ax - f i s - k o1 s
llegat	n	L ax - G a1 t
llegendari	n	L ax - Z ax n - d a1 - r i
llegirla	n	L ax - Z i1 rr - l ax
lleida	n	L e1 j - D ax
lleixa	n	L e1 - S ax
lleixes	n	L e1 - S ax s
llenguado	n	L ax N - g w a1 - D u
llengüetes	n	L ax N - g w E1 - t ax s
llentiscle	n	L ax n - t i1 s - k l ax
lleones	n	L ax - o1 - n ax s
lleopards	n	L ax - u - p a1 rr s
llepafils	n	L e - p ax - f i1 l s
llesta	n	L e1 s - t ax
lleterassa	n	L ax - t ax - r a1 - s ax
lletjota	n	L ax d - Z O1 - t ax
lletrejar	n	L ax - t r ax - Z a1
lleugerament	n	L ax uw - Z e - r ax - m e1 n
llibret	n	L i - B r E1 t
llicència	n	L i - s E1 n - s i - ax
lli	n	L i1
llimona	n	L i - m o1 - n ax
llis	n	L i1 s
llisos	n	L i1 - z u s
lliteres	n	L i - t e1 - r ax s
lliurament	n	L i uw - r ax - m e1 n
lliuraments	n	L i uw - r ax - m e1 n s
lliurement	n	L i uw - r ax - m e1 n
llívia	n	L i1 - B i - ax
llòbrec	n	L O1 - B r ax k
llobregat	n	L u - B r ax - G a1 t
llòbregues	n	L O1 - B r ax - G ax s
lloguer	n	L u - G e1
llom	n	L o1 m
llonganissa	n	L u N - g ax - n i1 - s ax
llonguets	n	L u N - g E1 t s
llorca	n	L O1 rr - k ax
llorenç	n	L u - r E1 n s
lloret	n	L u - r E1 t
lluch	n	L u1 k
llúcia	n	L u1 - s i - ax
llueix	n	L u - E1 S
lluenta	n	L u - e1 n - t ax
llufes	n	L u1 - f ax s
lluia	n	L u1 - y ax
lluirà	n	L u - i - r a1
lluïsa	n	L u - i1 - z ax
lluitador	n	L u j - t ax - D o1
llull	n	L u1 L
llumins	n	L u - m i1 n s
llúria	n	L u1 - r i - ax
localitza	n	l u - k ax - l i1 d - z ax
localitzar	n	l u - k ax - l i d - z a1
locomotora	n	l u - k u - m u - t o1 - r ax
locucions	n	l u - k u - s i - o1 n s
locutores	n	l u - k u - t o1 - r ax s
locutors	n	l u - k u - t o1 s
logarítmiques	n	l u - G ax - r i1 d - m i - k ax s
logotip	n	l u - G u - t i1 p
logronyès	n	l u - G r u - J E1 s
lo	n	l u
lom	n	l o1 m
londres	n	l o1 n - d r e s
loteries	n	l u - t ax - r i1 - ax s
louvre	n	l O1 uw b - rr ax
lovaina	n	l u - B a1 j - n ax
loyola	n	l u - y O1 - l ax
lucidesa	n	l u - s i - D E1 - z ax
lúcids	n	l u1 - s i t s
lúdics	n	l u1 - D i k s
lugo	n	l u1 - G u
lúgubre	n	l u1 - G u - B r ax
lund	n	l u1 n
luxe	n	l u1 k - s ax
luxemburguès	n	l u k - s ax m - b u r - G E1 s
luxes	n	l u1 k - s ax s
macarrons	n	m ax - k ax - rr o1 n s
macba	n	m a1 g - b ax
macdonalds	n	m ax g - d u - n a1 l s
madrid	n	m ax - D r i1 t
madrina	n	m ax - D r i1 - n ax
maduixer	n	m ax - D u - S e1
maduixes	n	m ax - D u1 - S ax s
madurs	n	m ax - D u1 s
màfies	n	m a1 - f i - ax s
màgia	n	m a1 - Z i - ax
màgic	n	m a1 - Z i k
magí	n	m ax - Z i1
mag	n	m a1 k
magma	n	m a1 g - m ax
magmes	n	m a1 g - m ax s
magnètica	n	m ax g - n E1 - t i - k ax
magníficament	n	m ax g - n i - f i - k ax - m e1 n
magnificent	n	m ax g - n i - f i - s e1 n
magnòlia	n	m ax g - n O1 - l i - ax
magog	n	m ax - G O1 k
magre	n	m a1 - G r ax
maharajàs	n	m ax - ax - r ax - Z a1 s
maies	n	m a1 - y ax s
maixella	n	m ax - S e1 - L ax
majestuosa	n	m ax - Z ax s - t u - o1 - z ax
majestuositat	n	m ax - Z ax s - t u - u - z i - t a1 t
majestuosos	n	m ax - Z ax s - t u - o1 - z u s
majoritàriament	n	m ax - Z u - r i - t a - r i - ax - m e1 n
majúscules	n	m ax - Z u1 s - k u - l ax s
malaguenya	n	m ax - l ax - G E1 - J ax
malament	n	m a - l ax - m e1 n
malauradament	n	m ax - l ax uw - r a - D ax - m e1 n
malbaratar	n	m a l - B ax - r ax - t a1
malbé	n	m a l - B e1
maldecap	n	m a l - d ax - k a1 p
maldestre	n	m a l - d e1 s - t r ax
maledicció	n	m ax - l ax - D i k - s i - o1
malediccions	n	m ax - l ax - D i k - s i - o1 n s
maleeixo	n	m ax - l ax - E1 - S u
malefici	n	m ax - l ax - f i1 - s i
maleint	n	m ax - l ax - i1 n
maleït	n	m ax - l ax - i1 t
malestar	n	m ax - l ax s - t a1
malformació	n	m a l - f u rr - m ax - s i - o1
malifetes	n	m a - l i - f E1 - t ax s
mallorca	n	m ax - L O1 rr - k ax
malone	n	m a - l o1 - n ax
malson	n	m a l - s O1 n
malsons	n	m a l - s O1 n s
malt	n	m a1 l
maltractaments	n	m a l - t r ax k - t ax - m e1 n s
maltractat	n	m a l - t r ax k - t a1 t
maltractats	n	m a l - t r ax k - t a1 t s
maltractes	n	m a l - t r a1 k - t ax s
malvat	n	m ax l - B a1 t
malvats	n	m ax l - B a1 t s
malversacions	n	m a l - B ax rr - s ax - s i - o1 n s
mamífer	n	m ax - m i1 - f ax
mamífers	n	m ax - m i1 - f ax s
managua	n	m ax - n a1 - G w ax
manchester	n	m ax N - tS ax s - t e1
mandra	n	m a1 n - d r ax
mandrosos	n	m ax n - d r o1 - z u s
maneig	n	m ax - n E1 tS
manetes	n	m ax - n E1 - t ax s
manga	n	m a1 N - g ax
mangueres	n	m ax N - g e1 - r ax s
manipular	n	m ax - n i - p u - l a1
maniquins	n	m ax - n i - k i1 n s
manlleu	n	m ax J - L e1 uw
manresa	n	m ax n - rr E1 - z ax
manualment	n	m ax - n u - a l - m e1 n
maqueta	n	m ax - k E1 - t ax
maquillatge	n	m ax - k i - L a1 d - Z ax
maquinari	n	m ax - k i - n a1 - r i
maragall	n	m ax - r ax - G a1 L
maragdes	n	m ax - r a1 g - d ax s
marajà	n	m ax - r ax - Z a1
marató	n	m ax - r ax - t o1
marcador	n	m ax rr - k ax - D o1
marceixi	n	m ax rr - s E1 - S i
marcet	n	m ax rr - s E1 t
marcides	n	m ax rr - s i1 - D ax s
mareig	n	m ax - r E1 tS
marejat	n	m ax - r ax - Z a1 t
marellenga	n	m ax - r ax - L E1 N - g ax
maremagnum	n	m ax - r ax - m ax g - n u1 m
maresme	n	m ax - r E1 z - m ax
margarides	n	m ax r - G ax - r i1 - D ax s
margarita	n	m ax r - G ax - r i1 - t ax
maria	n	m ax - r i1 - ax
mariana	n	m ax - r i - a1 - n ax
marieta	n	m ax - r i - E1 - t ax
mari	n	m a1 - r i
marimatxo	n	m ax - r i - m a1 t - S u
marín	n	m ax - r i1 n
mariona	n	m ax - r i - o1 - n ax
marisa	n	m ax - r i1 - z ax
marisc	n	m ax - r i1 s k
marquesina	n	m ax rr - k ax - z i1 - n ax
marroc	n	m ax - rr O1 k
marró	n	m ax - rr o1
marroquina	n	m ax - rr u - k i1 - n ax
marroquins	n	m ax - rr u - k i1 n s
marsellesa	n	m ax rr - s ax - L E1 - z ax
marta	n	m a1 rr - t ax
martens	n	m ax rr - t E1 n s
martínez	n	m ax rr - t i1 - n ax s
martingala	n	m ax rr - t i N - g a1 - l ax
martorell	n	m ax rr - t u - r e1 L
marxandatge	n	m ax rr - S ax n - d a1 d - Z ax
màscara	n	m a1 s - k ax - r ax
mascle	n	m a1 s - k l ax
masclista	n	m ax s - k l i1 s - t ax
mascota	n	m ax s - k O1 - t ax
mascotes	n	m ax s - k O1 - t ax s
masmorres	n	m ax z - m o1 - rr ax s
massacrats	n	m ax - s ax - k r a1 t s
massacre	n	m ax - s a1 - k r ax
massatge	n	m ax - s a1 d - Z ax
massatges	n	m ax - s a1 d - Z ax s
mastegant	n	m ax s - t ax - G a1 n
masteguin	n	m ax s - t E1 - G i n
mastercard	n	m ax s - t ax rr - k a1 rr t
matança	n	m ax - t a1 n - s ax
mataresies	n	m ax - t ax - r ax - z i1 - ax s
mataró	n	m ax - t ax - r o1
materialisme	n	m ax - t ax - r i - ax - l i1 z - m ax
materialitzar	n	m ax - t ax - r i - ax - l i d - z a1
matineres	n	m ax - t i - n e1 - r ax s
matiner	n	m ax - t i - n e1
matons	n	m ax - t o1 n s
matriculació	n	m ax - t r i - k u - l ax - s i - o1
matrícula	n	m ax - t r i1 - k u - l ax
matriculats	n	m ax - t r i - k u - l a1 t s
maxi	n	m a1 k - s i
maximitzaries	n	m ax k - s i - m i d - z ax - r i1 - ax s
maximitzar	n	m ax k - s i - m i d - z a1
mecenes	n	m ax - s E1 - n ax s
medalla	n	m ax - D a1 - L ax
medeix	n	m ax - D E1 S
medeixo	n	m ax - D E1 - S u
mediació	n	m ax - D i - ax - s i - o1
mediadors	n	m ax - D i - ax - D o1 s
mèdia	n	m E1 - D i - ax
mediàtic	n	m ax - D i - a1 - t i k
medicació	n	m ax - D i - k ax - s i - o1
medicinals	n	m ax - D i - s i - n a1 l s
medina	n	m ax - D i1 - n ax
mediocre	n	m ax - D i - O1 - k r ax
medir	n	m ax - D i1
meditació	n	m ax - D i - t ax - s i - o1
medul·la	n	m ax - D u1 - l ax
megabytes	n	m E - G ax - B i1 - t ax s
megahertzos	n	m E - G ax - E1 rr d - z u s
megues	n	m E1 - G ax s
melic	n	m ax - l i1 k
melodia	n	m ax - l u - D i1 - ax
melodies	n	m ax - l u - D i1 - ax s
melodramàtic	n	m ax - l u - D r ax - m a1 - t i k
melodramàtics	n	m ax - l u - D r ax - m a1 - t i k s
memorable	n	m ax - m u - r a1 b - b l ax
menera	n	m ax - n e1 - r ax
menjadora	n	m ax n - Z ax - D o1 - r ax
menstrual	n	m ax n s - t r u - a1 l
mentalment	n	m ax n - t a l - m e1 n
menta	n	m e1 n - t ax
mentider	n	m ax n - t i - D e1
mentir	n	m ax n - t i1
mentres	n	m e1 n - t r ax s
menú	n	m ax - n u1
menyspreable	n	m E J s - p r e - a1 b - b l ax
menyspreables	n	m E J s - p r e - a1 b - b l ax s
menyspreança	n	m E J s - p r e - a1 n - s ax
menyspreu	n	m E J s - p r E1 uw
meravellós	n	m ax - r ax - B ax - L o1 s
meravellosos	n	m ax - r ax - B ax - L o1 - z u s
mercadeig	n	m ax rr - k ax - D E1 tS
mercadillo	n	m ax rr - k ax - D i1 - L u
merda	n	m E1 r - D ax
meridians	n	m ax - r i - D i - a1 n s
meritxell	n	m ax - r i t - S e1 L
mesa	n	m E1 - z ax
mescla	n	m E1 s - k l ax
mesclava	n	m ax s - k l a1 - B ax
mescles	n	m E1 s - k l ax s
mésenger	n	m e1 - z ax n - Z ax
messenger	n	m ax - s ax n - Z e1
mestra	n	m E1 s - t r ax
mesurament	n	m ax - z u - r ax - m e1 n
metàfores	n	m ax - t a1 - f u - r ax s
metagresos	n	m E - t ax - G r E1 - z u s
metàl·lica	n	m ax - t a1 - l i - k ax
metàl·lics	n	m ax - t a1 - l i k s
metàl·liques	n	m ax - t a1 - l i - k ax s
metall	n	m ax - t a1 L
metamòrfica	n	m ax - t ax - m O1 rr - f i - k ax
metamòrfiques	n	m ax - t ax - m O1 rr - f i - k ax s
metamorfisme	n	m ax - t ax - m u rr - f i1 z - m ax
metamorfosi	n	m ax - t ax - m u rr - f O1 - z i
metamorfosis	n	m ax - t ax - m u rr - f O1 - z i s
metgessa	n	m ax d - Z E1 - s ax
meticulosament	n	m ax - t i - k u - l o - z ax - m e1 n
metro	n	m E1 - t r u
metropolità	n	m ax - t r u - p u - l i - t a1
metros	n	m e1 - t r u s
mèxic	n	m E1 k - s i k
mico	n	m i1 - k u
microcosmos	n	m i - k r u - k O1 z - m u s
micròfon	n	m i - k r O1 - f u n
microones	n	m i - k r u - o1 - n ax s
microsoft	n	m i - k r u - s o1 f t
microtalls	n	m i - k r u - t a1 L s
microurbanisme	n	m i - k r u r - B ax - n i1 z - m ax
migcampistes	n	m i tS - k ax m - p i1 s - t ax s
migdiada	n	m i dZ - D i - a1 - D ax
migdiades	n	m i dZ - D i - a1 - D ax s
migfondista	n	m i tS - f u n - d i1 s - t ax
migmatita	n	m i dZ - m ax - t i1 - t ax
migmetratge	n	m i dZ - m ax - t r a1 d - Z ax
migranyes	n	m i - G r a1 - J ax s
mijaran	n	m i - Z ax - r a1 n
mili	n	m i1 - l i
mil·lennis	n	m i - l E1 n - n i s
milles	n	m i1 - L ax s
milosevic	n	m i - l u - z ax - B i1 k
minera	n	m i - n e1 - r ax
mines	n	m i1 - n ax s
mínimament	n	m i - n i - m ax - m e1 n
minimitzar	n	m i - n i - m i d - z a1
minis	n	m i1 - n i s
ministeri	n	m i - n i s - t E1 - r i
minorització	n	m i - n u - r i d - z ax - s i - o1
minsa	n	m i1 n - s ax
minsk	n	m i1 n s k
minúscules	n	m i - n u1 s - k u - l ax s
minúscul	n	m i - n u1 s - k u l
minusvalidesa	n	m i - n u z - B ax - l i - D E1 - z ax
miocè	n	m i - u - s E1
miol	n	m i - O1 l
miopia	n	m i - u - p i1 - ax
miquelet	n	m i - k ax - l E1 t
miquel	n	m i - k E1 l
mirador	n	m i - r ax - D o1
miraments	n	m i - r ax - m e1 n s
mirandes	n	m i - r a1 n - d ax s
miratge	n	m i - r a1 d - Z ax
mireia	n	m i - r E1 - y ax
mir	n	m i1 rr
miró	n	m i - r o1
mirúrgia	n	m i - r u1 rr - Z i - ax
miscel·lània	n	m i - s ax - l a1 - n i - ax
miserablement	n	m i - z ax - r a b - b l ax - m e1 n
miserable	n	m i - z ax - r a1 b - b l ax
miseriosa	n	m i - z ax - r i - o1 - z ax
misogin	n	m i - z O1 - Z i n
missatgeria	n	m i - s ax d - Z ax - r i1 - ax
missatger	n	m i - s ax d - Z e1
mitificació	n	m i - t i - f i - k ax - s i - o1
mitjancer	n	m i d - Z ax n - s e1
mitjanit	n	m i d - Z ax - n i1 t
mitjons	n	m i d - Z o1 n s
mitològiques	n	m i - t u - l O1 - Z i - k ax s
mixeta	n	m i - S E1 - t ax
mobiliari	n	m u - B i - l i - a1 - r i
mobilitzen	n	m u - B i - l i1 d - z ax n
moblat	n	m u b - b l a1 t
mocar	n	m u - k a1
moderadors	n	m u - D ax - r ax - D o1 s
modernitzar	n	m u - D ax rr - n i d - z a1
mòdul	n	m O1 - D u l
mohamed	n	m u - ax - m E1 t
moixetes	n	m u - S E1 - t ax s
molèstia	n	m u - l E1 s - t i - ax
molèsties	n	m u - l E1 s - t i - ax s
molinet	n	m u - l i - n E1 t
mollerussa	n	m u - L ax - r u1 - s ax
mollet	n	m u - L E1 t
mònaco	n	m O1 - n a - k o
moneder	n	m u - n ax - D e1
mongol	n	m u N - g O1 l
mònica	n	m O1 - n i - k ax
monitoritza	n	m u - n i - t u - r i1 d - z ax
monitor	n	m u - n i - t o1
monjos	n	m O1 n - Z u s
monòleg	n	m u - n O1 - l ax k
monotonia	n	m u - n u - t u - n i1 - ax
monstruositats	n	m u n s - t r u - u - z i - t a1 t s
montblanc	n	m o m - b l a1 N
montcada	n	m o N - k a1 - D ax
montgat	n	m o N - g a1 t
montjuïc	n	m o n - Z u - i1 k
mont	n	m o1 n
montsec	n	m o n - s E1 k
montse	n	m o1 n - s e
montseny	n	m o n - s E1 J
montserrat	n	m u n - s ax - rr a1 t
montsià	n	m u n - s i - a1
moralina	n	m u - r ax - l i1 - n ax
mora	n	m O1 - r ax
móra	n	m o1 - r ax
moratinos	n	m u - r ax - t i1 - n u s
mòrbida	n	m O1 r - B i - D ax
morbositat	n	m u r - B u - z i - t a1 t
morena	n	m u - r E1 - n ax
morera	n	m u - r e1 - r ax
moreres	n	m u - r e1 - r ax s
mores	n	m O1 - r ax s
morfosintàctics	n	m u rr - f u - z i n - t a1 k - t i k s
moribund	n	m u - r i - B u1 n
morro	n	m o1 - rr u
morros	n	m o1 - rr u s
morses	n	m o1 rr - s ax s
mortalla	n	m u rr - t a1 - L ax
mortífer	n	m u rr - t i1 - f ax
mosso	n	m o1 - s u
mossos	n	m o1 - s u s
mostrador	n	m u s - t r ax - D o1
mostradors	n	m u s - t r ax - D o1 s
motlle	n	m O1 L - L ax
motllura	n	m u L - L u1 - r ax
motllures	n	m u L - L u1 - r ax s
moto	n	m o1 - t u
motxilla	n	m u t - S i1 - L ax
mudar	n	m u - D a1
mudes	n	m u1 - D ax s
müller	n	m u - L e1
multa	n	m u1 l - t ax
multarà	n	m u l - t ax - r a1
multicultural	n	m u l - t i - k u l - t u - r a1 l
multiculturals	n	m u l - t i - k u l - t u - r a1 l s
multiètnica	n	m u l - t i - E1 d - n i - k ax
multimèdia	n	m u l - t i - m E1 - D i - ax
multinacional	n	m u l - t i - n ax - s i - u - n a1 l
multiplicitat	n	m u l - t i - p l i - s i - t a1 t
munió	n	m u - n i - o1
musculatura	n	m u s - k u - l ax - t u1 - r ax
múscul	n	m u1 s - k u l
musculosos	n	m u s - k u - l o1 - z u s
museòlegs	n	m u - z ax - O1 - l ax k s
mussol	n	m u - s O1 l
mussols	n	m u - s O1 l s
mutilacions	n	m u - t i - l ax - s i - o1 n s
mútuament	n	m u - t u - ax - m e1 n
myller	n	m i - L e1
nacre	n	n a1 - k r ax
nadal	n	n ax - D a1 l
nafres	n	n a1 - f r ax s
naips	n	n a1 j p s
nairobi	n	n ax j - r O1 - B i
nanos	n	n a1 - n u s
napoleònic	n	n ax - p u - l ax - O1 - n i k
nàpols	n	n a1 - p u l s
narcòtic	n	n ax rr - k O1 - t i k
narra	n	n a1 - rr ax
nasa	n	n a1 - z ax
nassarró	n	n ax - s ax - rr o1
natació	n	n ax - t ax - s i - o1
natàlia	n	n ax - t a1 - l i - ax
natges	n	n a1 d - Z ax s
nativa	n	n ax - t i1 - B ax
naturalisme	n	n ax - t u - r ax - l i1 z - m ax
naturalment	n	n ax - t u - r a l - m e1 n
naturisme	n	n ax - t u - r i1 z - m ax
naufragi	n	n ax uw - f r a1 - Z i
nàufrag	n	n a1 - u - f r ax k
nauseabunda	n	n ax uw - z e - ax - B u1 n - d ax
nauseabund	n	n ax uw - z e - ax - B u1 n
nàusea	n	n a1 - u - z e - ax
nàusees	n	n a1 - u - z e - ax s
navarra	n	n ax - B a1 - rr ax
navarreses	n	n ax - B ax - rr E1 - z ax s
navegador	n	n ax - B ax - G ax - D o1
navega	n	n ax - B E1 - G ax
navegant	n	n ax - B ax - G a1 n
navegueu	n	n ax - B ax - G E1 uw
naveguin	n	n ax - B E1 - G i n
neanderthalensis	n	n e - ax n - d ax rr - t ax - l E1 n - s i s
neboda	n	n ax - B o1 - D ax
nèctar	n	n E1 k - t ax rr
nedadora	n	n ax - D ax - D o1 - r ax
negligència	n	n ax - G l i - Z E1 n - s i - ax
negociant	n	n ax - G u - s i - a1 n
negociar	n	n ax - G u - s i - a1
negretes	n	n ax - G r E1 - t ax s
neguit	n	n ax - G i1 t
neogòtic	n	n e - u - G O1 - t i k
neorealistes	n	n e - u - rr e - ax - l i1 s - t ax s
nerviosisme	n	n ax r - B i - u - z i1 z - m ax
netscape	n	n ax ts - k a1 - p ax
neurofibromatosi	n	n E uw - r u - f i - B r u - m ax - t O1 - z i
neutralitat	n	n ax uw - t r ax - l i - t a1 t
nevades	n	n ax - B a1 - D ax s
nevera	n	n ax - B e1 - r ax
nicaragua	n	n i - k ax - r a1 - G w ax
nicolau	n	n i - k u - l a1 uw
nico	n	n i1 - k u
nihilista	n	n i - i - l i1 s - t ax
nihilistes	n	n i - i - l i1 s - t ax s
nineta	n	n i - n E1 - t ax
ninetes	n	n i - n E1 - t ax s
ninos	n	n i1 - n u s
ninots	n	n i - n O1 t s
nissaga	n	n i - s a1 - G ax
nítida	n	n i1 - t i - D ax
noble	n	n o1 b - b l ax
noblesa	n	n u b - b l E1 - z ax
nobles	n	n o1 b - b l ax s
noces	n	n O1 - s ax s
nocompetitivitat	n	n u - k u m - p ax - t i - t i - B i - t a1 t
node	n	n O1 - D ax
nodreixen	n	n u - D r E1 - S ax n
nogueira	n	n u - G E1 j - r ax
noguera	n	n u - G e1 - r ax
noieta	n	n u - y E1 - t ax
noietes	n	n u - y E1 - t ax s
noiet	n	n u - y E1 t
nòmina	n	n O1 - m i - n ax
norfeu	n	n u rr - f E1 uw
normalitzar	n	n u rr - m ax - l i d - z a1
normalment	n	n u rr - m a l - m e1 n
noruega	n	n u - r u - E1 - G ax
nosocomials	n	n u - z u - k u - m i - a1 l s
notificacions	n	n u - t i - f i - k ax - s i - o1 n s
notificació	n	n u - t i - f i - k ax - s i - o1
noucentisme	n	n O uw - s ax n - t i1 z - m ax
nousnats	n	n O uw - z n a1 t s
novament	n	n O - B ax - m e1 n
nuesa	n	n u - E1 - z ax
núria	n	n u1 - r i - ax
nutrició	n	n u - t r i - s i - o1
nutrients	n	n u - t r i - e1 n s
nuvolet	n	n u - B u - l E1 t
oasi	n	u - a1 - z i
obcecada	n	u p - s ax - k a1 - D ax
obnubilants	n	u b - n u - B i - l a1 n s
obnubilava	n	u b - n u - B i - l a1 - B ax
obrecartes	n	u - B r ax - k a1 rr - t ax s
obscurs	n	u p s - k u1 rr s
obsequiat	n	u p - s ax - k i - a1 t
obsequia	n	u p - s ax - k i1 - ax
obsessivament	n	u p - s ax - s i - B ax - m e1 n
obsessives	n	u p - s ax - s i1 - B ax s
obsés	n	u p - s e1 s
obusos	n	u - B u1 - z u s
òbviament	n	O b - b i - ax - m e1 n
Òbviament	n	O b - b i - ax - m e1 n
obviar	n	u b - b i - a1
ocasionar	n	u - k ax - z i - u - n a1
ocellets	n	u - s ax - L E1 t s
oci	n	O1 - s i
ocultar	n	u - k u l - t a1
ocultes	n	u - k u1 l - t ax s
odiava	n	u - D i - a1 - B ax
ofendre	n	u - f E1 n - d r ax
ofimàtica	n	u - f i - m a1 - t i - k ax
ofrena	n	u - f r E1 - n ax
ofrenes	n	u - f r E1 - n ax s
oftalmòleg	n	u f - t ax l - m O1 - l ax k
oïda	n	u - i1 - D ax
oïdor	n	u - i - D o1
olga	n	O1 l - G ax
oliosos	n	u - l i - o1 - z u s
onanista	n	u - n ax - n i1 s - t ax
ona	n	o1 - n ax
ones	n	o1 - n ax s
onu	n	o1 - n u
onyar	n	u - J a1
ö	n	o1
opcionals	n	u p - s i - u - n a1 l s
operadores	n	u - p ax - r ax - D o1 - r ax s
operador	n	u - p ax - r ax - D o1
operaris	n	u - p ax - r a1 - r i s
oppida	n	u p - p i1 - D ax
oprimeixen	n	u - p r i - m E1 - S ax n
oprimeix	n	u - p r i - m E1 S
òptic	n	O1 p - t i k
optimisme	n	u p - t i - m i1 z - m ax
oracle	n	u - r a1 - k l ax
oralment	n	u - r a l - m e1 n
oratge	n	u - r a1 d - Z ax
orbs	n	O1 rr p s
ordenança	n	u r - D ax - n a1 n - s ax
ordenances	n	u r - D ax - n a1 n - s ax s
orde	n	o1 r - D ax
ordinadors	n	u r - D i - n ax - D o1 s
ordinador	n	u r - D i - n ax - D o1
ordi	n	O1 r - D i
oreneta	n	u - r ax - n E1 - t ax
organitzadors	n	u r - G ax - n i d - z ax - D o1 s
orgies	n	u rr - Z i1 - ax s
orgullosament	n	u r - G u - L o - z ax - m e1 n
orgullosos	n	u r - G u - L o1 - z u s
orgullós	n	u r - G u - L o1 s
orinal	n	u - r i - n a1 l
orina	n	u - r i1 - n ax
orquestra	n	u rr - k e1 s - t r ax
oslo	n	o1 z - l o
osona	n	u - z o1 - n ax
óssos	n	o1 - s u s
ostatge	n	u s - t a1 d - Z ax
ostres	n	O1 s - t r ax s
otto	n	o1 - t u
ourense	n	o uw - r E1 n - s ax
ovació	n	u - B ax - s i - o1
ovni	n	O1 b - n i
òvul	n	O1 - B u l
oxigen	n	u k - s i1 - Z ax n
pablo	n	p a1 b - b l u
pacientment	n	p ax - s i - e m - m e1 n
padró	n	p ax - D r o1
paella	n	p ax - e1 - L ax
paeria	n	p ax - e - r i1 - ax
pagador	n	p ax - G ax - D o1
pague	n	p a1 - G ax
paio	n	p a1 - y u
pair	n	p ax - i1
paisatgisme	n	p ax j - z ax d - Z i1 z - m ax
paixtu	n	p a1 S - t u
paixtus	n	p a1 S - t u s
paladar	n	p ax - l ax - D a1
palafrugell	n	p ax - l ax - f r u - Z e1 L
palanca	n	p ax - l a1 N - k ax
pala	n	p a1 - l ax
palauencs	n	p ax - l ax - w E1 N s
palauet	n	p ax - l ax - w E1 t
palència	n	p ax - l E1 n - s i - ax
paleozoic	n	p ax - l e - u - z O1 j k
pallars	n	p ax - L a1 s
pallasso	n	p ax - L a1 - s u
pal·lidesa	n	p ax - l i - D E1 - z ax
pallissa	n	p ax - L i1 - s ax
palmeral	n	p ax l - m ax - r a1 l
palplantada	n	p a l - p l ax n - t a1 - D ax
palplantat	n	p a l - p l ax n - t a1 t
pampallugues	n	p ax m - p ax - L u1 - G ax s
pancarta	n	p ax N - k a1 rr - t ax
pandora	n	p ax n - d o1 - r ax
panellets	n	p ax - n ax - L E1 t s
pànic	n	p a1 - n i k
pansides	n	p ax n - s i1 - D ax s
pantalla	n	p ax n - t a1 - L ax
pantalons	n	p ax n - t ax - l o1 n s
pantera	n	p ax n - t e1 - r ax
pantocràtor	n	p ax n - t o - k r a1 - t o rr
pantògrafs	n	p ax n - t O1 - G r ax f s
paperera	n	p ax - p ax - r e1 - r ax
papereria	n	p ax - p ax - r ax - r i1 - ax
paperet	n	p ax - p ax - r E1 t
paradetes	n	p ax - r ax - D E1 - t ax s
parafraseja	n	p ax - r ax - f r ax - z E1 - Z ax
paraguaià	n	p ax - r ax - G w ax - y a1
paraigüer	n	p ax - r ax j - G w e1
paraigüet	n	p ax - r ax j - G w E1 t
paralitzar	n	p ax - r ax - l i d - z a1
paral·lelogram	n	p ax - r ax - l ax - l u - G r a1 m
paràsit	n	p ax - r a1 - z i t
paratges	n	p ax - r a1 d - Z ax s
parentes	n	p ax - r e1 n - t ax s
parisencs	n	p ax - r i - z E1 N s
parisina	n	p ax - r i - z i1 - n ax
parís	n	p ax - r i1 s
parpelleges	n	p ax rr - p ax - L E1 - Z ax s
parpelleig	n	p ax rr - p ax - L E1 tS
parpellejar	n	p ax rr - p ax - L ax - Z a1
parpellejava	n	p ax rr - p ax - L ax - Z a1 - B ax
pàrquing	n	p a1 rr - k i N
parracs	n	p ax - rr a1 k s
partició	n	p ax rr - t i - s i - o1
participants	n	p ax rr - t i - s i - p a1 n s
particularment	n	p ax rr - t i - k u - l a rr - m e1 n
partideta	n	p ax rr - t i - D E1 - t ax
passable	n	p ax - s a1 b - b l ax
passaport	n	p a - s ax - p O1 rr t
pasteur	n	p ax s - t E1 uw
pastissos	n	p ax s - t i1 - s u s
pastosa	n	p ax s - t o1 - z ax
pastrana	n	p ax s - t r a1 - n ax
paté	n	p ax - t e1
patètiques	n	p ax - t E1 - t i - k ax s
patinades	n	p ax - t i - n a1 - D ax s
patinet	n	p ax - t i - n E1 t
patras	n	p a1 - t r ax s
patriarca	n	p ax - t r i - a1 rr - k ax
patrick	n	p ax - t r i1 k
patrocini	n	p ax - t r u - s i1 - n i
patronat	n	p ax - t r u - n a1 t
patrulla	n	p ax - t r u1 - L ax
patrullarà	n	p ax - t r u - L ax - r a1
patrulles	n	p ax - t r u1 - L ax s
paula	n	p a1 uw - l ax
paulatinament	n	p ax uw - l ax - t i - n ax - m e1 n
paulo	n	p a1 uw - l u
pausa	n	p a1 uw - z ax
pavelló	n	p ax - B ax - L o1
peatges	n	p e - a1 d - Z ax s
peatons	n	p e - ax - t o1 n s
pebre	n	p E1 - B r ax
pedaços	n	p ax - D a1 - s u s
pedant	n	p ax - D a1 n
pediatres	n	p ax - D i - a1 - t r ax s
pediàtriques	n	p ax - D i - a1 - t r i - k ax s
pedofília	n	p ax - D u - f i1 - l i - ax
pedregada	n	p ax - D r ax - G a1 - D ax
pedreta	n	p ax - D r E1 - t ax
pega	n	p e1 - G ax
pegues	n	p e1 - G ax s
peixatera	n	p ax - S ax - t e1 - r ax
pelegrins	n	p ax - l ax - G r i1 n s
pel·lícules	n	p ax - l i1 - k u - l ax s
penada	n	p ax - n a1 - D ax
penedesencs	n	p ax - n ax - D ax - z E1 N s
penedès	n	p ax - n ax - D E1 s
penedir	n	p ax - n ax - D i1
penèlope	n	p ax - n E1 - l u - p ax
pengim	n	p ax n - Z i1 m
penis	n	p E1 - n i s
penitència	n	p ax - n i - t E1 n - s i - ax
penjador	n	p ax n - Z ax - D o1
penjarella	n	p ax n - Z ax - r e1 - L ax
penjolls	n	p ax n - Z O1 L s
pensaveu	n	p ax n - s ax - B E1 uw
pensions	n	p ax n - s i - o1 n s
pensió	n	p ax n - s i - o1
pentàgons	n	p ax n - t a1 - G u n s
pentinen	n	p ax n - t i1 - n ax n
pentino	n	p ax n - t i1 - n u
peons	n	p ax - o1 n s
percussió	n	p ax rr - k u - s i - o1
perdedors	n	p ax r - D ax - D o1 s
perdurable	n	p ax r - D u - r a1 b - b l ax
perecamps	n	p ax - r ax - k a1 m s
perelada	n	p ax - r ax - l a1 - D ax
pere	n	p e1 - r ax
perfeccionistes	n	p ax rr - f ax k - s i - u - n i1 s - t ax s
perfectament	n	p ax rr - f e k - t ax - m e1 n
perfídia	n	p ax rr - f i1 - D i - ax
perforant	n	p ax rr - f u - r a1 n
perfumada	n	p ax rr - f u - m a1 - D ax
pergamins	n	p ax r - G ax - m i1 n s
pericial	n	p ax - r i - s i - a1 l
perímetre	n	p ax - r i1 - m ax - t r ax
periòdica	n	p ax - r i - O1 - D i - k ax
periodicitat	n	p ax - r i - u - D i - s i - t a1 t
peripècia	n	p ax - r i - p E1 - s i - ax
periquito	n	p ax - r i - k i1 - t u
peris	n	p E1 - r i s
permanyer	n	p ax rr - m ax - J e1
permeables	n	p ax rr - m e - a1 b - b l ax s
permisos	n	p ax rr - m i1 - z u s
perpendiculars	n	p ax rr - p ax n - d i - k u - l a1 rr s
perpetrar	n	p ax rr - p ax - t r a1
perpetren	n	p ax rr - p e1 - t r ax n
perque	n	p E1 rr - k ax
perramon	n	p ax - rr ax - m o1 n
perruquera	n	p ax - rr u - k e1 - r ax
perruqueria	n	p ax - rr u - k ax - r i1 - ax
perruqueries	n	p ax - rr u - k ax - r i1 - ax s
perruquer	n	p ax - rr u - k e1
persianes	n	p ax rr - s i - a1 - n ax s
personada	n	p ax rr - s u - n a1 - D ax
personalització	n	p ax rr - s u - n ax - l i d - z ax - s i - o1
personalitzada	n	p ax rr - s u - n ax - l i d - z a1 - D ax
personalitzant	n	p ax rr - s u - n ax - l i d - z a1 n
personalitza	n	p ax rr - s u - n ax - l i1 d - z ax
personalment	n	p ax rr - s u - n a l - m e1 n
persuadir	n	p ax rr - s u - ax - D i1
pertenences	n	p ax rr - t ax - n E1 n - s ax s
perxes	n	p E1 rr - S ax s
pesants	n	p ax - z a1 n s
pessigolles	n	p ax - s i - G O1 - L ax s
pessimista	n	p ax - s i - m i1 s - t ax
pestanya	n	p ax s - t a1 - J ax
pestanyes	n	p ax s - t a1 - J ax s
peta	n	p E1 - t ax
petards	n	p ax - t a1 rr s
petar	n	p ax - t a1
peter	n	p ax - t e1
petitburgès	n	p ax - t i d - b u rr - Z E1 s
petitet	n	p ax - t i - t E1 t
petitíssims	n	p ax - t i - t i1 - s i m s
petitona	n	p ax - t i - t o1 - n ax
peto	n	p E1 - t u
petrificats	n	p ax - t r i - f i - k a1 t s
petroli	n	p ax - t r O1 - l i
peuets	n	p ax - w E1 t s
philippe	n	p i - l i1 p - p ax
picarols	n	p i - k ax - r O1 l s
picasso	n	p i - k a1 - s u
pícnic	n	p i1 g - n i k
picor	n	p i - k o1
picotegen	n	p i - k u - t E1 - Z ax n
pigmeus	n	p i g - m E1 uw s
pilota	n	p i - l O1 - t ax
pilotes	n	p i - l O1 - t ax s
pime	n	p i1 - m e
pingu	n	p i1 N - g u
pinineus	n	p i - n i - n E1 uw s
pin	n	p i1 n
pintallavis	n	p i n - t ax - L a1 - B i s
pintoresca	n	p i n - t u - r E1 s - k ax
pinya	n	p i1 - J ax
pinyes	n	p i1 - J ax s
pip	n	p i1 p
piragua	n	p i - r a1 - G w ax
piràmide	n	p i - r a1 - m i - D ax
pirates	n	p i - r a1 - t ax s
pirineu	n	p i - r i - n E1 uw
pirineus	n	p i - r i - n E1 uw s
piscina	n	p i - s i1 - n ax
piscines	n	p i - s i1 - n ax s
piset	n	p i - z E1 t
pista	n	p i1 s - t ax
piti	n	p i1 - t i
pitó	n	p i - t o1
pivetti	n	p i - B e1 - t i
pivot	n	p i - B O1 t
pixels	n	p i - S E1 l s
pix	n	p i1 k s
pizzeria	n	p i z - z ax - r i1 - ax
pizzes	n	p i1 z - z ax s
placeta	n	p l ax - s E1 - t ax
plaçeta	n	p l ax - s E1 - t ax
plàcidament	n	p l a - s i - D ax - m e1 n
placidesa	n	p l ax - s i - D E1 - z ax
pladellorens	n	p l ax - D ax - L u - r E1 n s
plagi	n	p l a1 - Z i
planctòniques	n	p l ax N - t O1 - n i - k ax s
plàncton	n	p l a1 N - t o n
planer	n	p l ax - n e1
planeta	n	p l ax - n E1 - t ax
planetes	n	p l ax - n E1 - t ax s
planificada	n	p l ax - n i - f i - k a1 - D ax
plantilla	n	p l ax n - t i1 - L ax
planyis	n	p l a1 - J i s
plasmar	n	p l ax z - m a1
plataforma	n	p l ax - t ax - f o1 rr - m ax
platea	n	p l ax - t e1 - ax
platejada	n	p l ax - t ax - Z a1 - D ax
plebeus	n	p l ax - B E1 uw s
pledejar	n	p l ax - D ax - Z a1
plegable	n	p l ax - G a1 b - b l ax
plegables	n	p l ax - G a1 b - b l ax s
plèiade	n	p l E1 - y ax - D ax
plenament	n	p l E - n ax - m e1 n
plenàries	n	p l ax - n a1 - r i - ax s
pliocè	n	p l i - u - s E1
plomalls	n	p l u - m a1 L s
plom	n	p l o1 m
ploraner	n	p l u - r ax - n e1
plumero	n	p l u - m e1 - r u
plurilingüisme	n	p l u - r i - l i N - g w i1 z - m ax
pluviòmetre	n	p l u - B i - O1 - m ax - t r ax
pneumàtics	n	p n ax uw - m a1 - t i k s
pneumocòcica	n	p n E uw - m u - k O1 - s i - k ax
pneumònia	n	p n ax uw - m O1 - n i - ax
poblet	n	p u b - b l E1 t
poblets	n	p u b - b l E1 t s
pobret	n	p u - B r E1 t
podés	n	p u - D e1 s
podi	n	p o1 - D i
podreixi	n	p u - D r E1 - S i
podrit	n	p u - D r i1 t
policial	n	p O - l i - s i - a1 l
políedre	n	p u - l i1 - ax - D r ax
polièdrica	n	p u - l i - E1 - D r i - k ax
poliesportiu	n	p O - l i - ax s - p u rr - t i1 uw
polièster	n	p u - l i - E1 s - t ax
poliestiré	n	p O - l i - ax s - t i - r e1
poligonals	n	p u - l i - G u - n a1 l s
polígon	n	p u - l i1 - G u n
polisèmia	n	p u - l i - s E1 - m i - ax
politècnica	n	p u - l i - t E1 g - n i - k ax
pollancres	n	p u - L a1 N - k r ax s
polleguera	n	p u - L ax - G e1 - r ax
polonesa	n	p u - l u - n E1 - z ax
polònia	n	p u - l O1 - n i - ax
polsegosa	n	p u l - s ax - G o1 - z ax
polseguera	n	p u l - s ax - G e1 - r ax
polsim	n	p u l - s i1 m
pòlvora	n	p O1 l - B u - r ax
polvoritzat	n	p u l - B u - r i d - z a1 t
polze	n	p o1 l - z ax
pomada	n	p u - m a1 - D ax
pompidou	n	p u m - p i - D O1 uw
ponç	n	p O1 n s
pontevedra	n	p u n - t ax - B e1 - D r ax
popes	n	p O1 - p ax s
pop	n	p o1 p
poprock	n	p u - p r O1 k
porcelanosa	n	p u rr - s ax - l ax - n o1 - z ax
porc	n	p O1 rr k
porós	n	p u - r o1 s
porqueria	n	p u rr - k ax - r i1 - ax
porquets	n	p u rr - k E1 t s
porro	n	p o1 - rr u
portadors	n	p u rr - t ax - D o1 s
portaveu	n	p O rr - t ax - B E1 uw
portuari	n	p u rr - t u - a1 - r i
portugal	n	p u rr - t u - G a1 l
porxada	n	p u rr - S a1 - D ax
porxo	n	p O1 rr - S u
posicionament	n	p u - z i - s i - o - n ax - m e1 n
posiciona	n	p u - z i - s i - o1 - n ax
posicioni	n	p u - z i - s i - O1 - n i
positivament	n	p u - z i - t i - B ax - m e1 n
pòsits	n	p O1 - z i t s
possiblement	n	p u - s i b - b l ax - m e1 n
postal	n	p u s - t a1 l
postals	n	p u s - t a1 l s
postdata	n	p O z - D a1 - t ax
postes	n	p O1 s - t ax s
postisses	n	p u s - t i1 - s ax s
postproducció	n	p O s - p r u - D u k - s i - o1
postres	n	p O1 s - t r ax s
postrina	n	p O z - rr i1 - n ax
postromàntica	n	p O z - rr u - m a1 n - t i - k ax
pòstum	n	p O1 s - t u m
postura	n	p u s - t u1 - r ax
potetes	n	p u - t E1 - t ax s
practicables	n	p r ax k - t i - k a1 b - b l ax s
pràcticament	n	p r a k - t i - k ax - m e1 n
praga	n	p r a1 - G ax
prebèl·lica	n	p r e - B E1 - l i - k ax
precarietat	n	p r e - k ax - r i - ax - t a1 t
precaució	n	p r ax - k ax uw - s i - o1
preciositat	n	p r ax - s i - u - z i - t a1 t
precisament	n	p r ax - s i - z ax - m e1 n
precompilació	n	p r e - k u m - p i - l ax - s i - o1
precursors	n	p r ax - k u rr - s o1 s
predel·la	n	p r ax - D E1 - l ax
preferent	n	p r ax - f ax - r e1 n
pregar	n	p r ax - G a1
pregó	n	p r ax - G o1
preguem	n	p r ax - G E1 m
pregués	n	p r ax - G e1 s
prehistòrics	n	p r ax - i s - t O1 - r i k s
premeditada	n	p r ax - m ax - D i - t a1 - D ax
premem	n	p r ax - m E1 m
premen	n	p r e1 - m ax n
prémer	n	p r e1 - m ax
premeu	n	p r ax - m E1 uw
premià	n	p r ax - m i - a1
premi	n	p r E1 - m i
premo	n	p r e1 - m u
prem	n	p r e1 m
prerafaelites	n	p r e - rr ax - f ax - e - l i1 - t ax s
preromàntics	n	p r e - rr u - m a1 n - t i k s
presencial	n	p r ax - z ax n - s i - a1 l
presentadora	n	p r ax - z ax n - t ax - D o1 - r ax
preservar	n	p r ax - z ax r - B a1
presoneres	n	p r ax - z u - n e1 - r ax s
préssec	n	p r e1 - s ax k
prestacions	n	p r ax s - t ax - s i - o1 n s
prestació	n	p r ax s - t ax - s i - o1
prestatgeria	n	p r ax s - t ax d - Z ax - r i1 - ax
prestatgeries	n	p r ax s - t ax d - Z ax - r i1 - ax s
presumir	n	p r ax - z u - m i1
presumpte	n	p r ax - z u1 m - t ax
preventiu	n	p r ax - B ax n - t i1 uw
preventiva	n	p r ax - B ax n - t i1 - B ax
prèviament	n	p r E - B i - ax - m e1 n
primigeni	n	p r i - m i - Z E1 - n i
princesa	n	p r i n - s E1 - z ax
principalment	n	p r i n - s i - p a l - m e1 n
pringo	n	p r i1 N - g u
prió	n	p r i - o1
priorat	n	p r i - u - r a1 t
priori	n	p r i - O1 - r i
prioritari	n	p r i - u - r i - t a1 - r i
prioritaris	n	p r i - u - r i - t a1 - r i s
prioritat	n	p r i - u - r i - t a1 t
prioritats	n	p r i - u - r i - t a1 t s
privacions	n	p r i - B ax - s i - o1 n s
privatiu	n	p r i - B ax - t i1 uw
probablement	n	p r u - B a b - b l ax - m e1 n
problemàtics	n	p r u - B l ax - m a1 - t i k s
procedimentals	n	p r u - s ax - D i - m ax n - t a1 l s
procrea	n	p r u - k r e1 - ax
procrear	n	p r u - k r e - a1
procreat	n	p r u - k r e - a1 t
procuradors	n	p r u - k u - r ax - D o1 s
prodi	n	p r O1 - D i
proeses	n	p r u - E1 - z ax s
proferir	n	p r u - f ax - r i1
professionalitat	n	p r u - f ax - s i - u - n ax - l i - t a1 t
professorat	n	p r u - f ax - s u - r a1 t
profunditza	n	p r u - f u n - d i1 d - z ax
progenitor	n	p r u - Z ax - n i - t o1
programacions	n	p r u - G r ax - m ax - s i - o1 n s
programació	n	p r u - G r ax - m ax - s i - o1
programari	n	p r u - G r ax - m a1 - r i
progressista	n	p r u - G r ax - s i1 s - t ax
projector	n	p r u - Z ax k - t o1
prolegòmen	n	p r u - l ax - G O1 - m ax n
promig	n	p r u - m i1 tS
promocionin	n	p r u - m u - s i - O1 - n i n
propagandístic	n	p r u - p ax - G ax n - d i1 s - t i k
propiciar	n	p r u - p i - s i - a1
propici	n	p r u - p i1 - s i
propinar	n	p r u - p i - n a1
proporcionalitat	n	p r u - p u rr - s i - u - n ax - l i - t a1 t
prorrogables	n	p r u - rr u - G a1 b - b l ax s
pròrroga	n	p r O1 - rr u - G ax
prorroguen	n	p r u - rr O1 - G ax n
prospecte	n	p r u s - p e1 k - t ax
prosperava	n	p r u s - p ax - r a1 - B ax
pròsper	n	p r O1 s - p ax rr
prostitutes	n	p r u s - t i - t u1 - t ax s
protector	n	p r u - t ax k - t o1
protesta	n	p r u - t e1 s - t ax
protestar	n	p r u - t ax s - t a1
protesto	n	p r u - t e1 s - t u
protocol	n	p r u - t u - k O1 l
proveïdor	n	p r u - B ax - i - D o1
proveïts	n	p r u - B ax - i1 t s
provença	n	p r u - B E1 n - s ax
provisions	n	p r u - B i - z i - o1 n s
provocacions	n	p r u - B u - k ax - s i - o1 n s
pseudònim	n	p s ax uw - D O1 - n i m
psicoanalitzant	n	p s i - k u - ax - n ax - l i d - z a1 n
psicòpates	n	p s i - k O1 - p ax - t ax s
psiquiatra	n	p s i - k i - a1 - t r ax
pubilla	n	p u - B i1 - L ax
publicitàries	n	p u - B l i - s i - t a1 - r i - ax s
publicitari	n	p u - B l i - s i - t a1 - r i
publicitaris	n	p u - B l i - s i - t a1 - r i s
publicitat	n	p u - B l i - s i - t a1 t
pudent	n	p u - D e1 n
puerto	n	p u - E1 rr - t u
puigcerdà	n	p u t - S ax r - D a1
puigdàlber	n	p u dZ - D a1 l - B ax
puigdevall	n	p u dZ - D ax - B a1 L
puigneró	n	p u dZ - n ax - r o1
pulcre	n	p u1 l - k r ax
pulsim	n	p u l - s i1 m
punteria	n	p u n - t ax - r i1 - ax
puntetes	n	p u n - t E1 - t ax s
puntilles	n	p u n - t i1 - L ax s
puntuació	n	p u n - t u - ax - s i - o1
puntualitzem	n	p u n - t u - ax - l i d - z E1 m
puntuals	n	p u n - t u - a1 l s
punxadeta	n	p u n - S ax - D E1 - t ax
punyet	n	p u - J E1 t
pupil·les	n	p u - p i1 - l ax s
puré	n	p u - r e1
puresa	n	p u - r E1 - z ax
pus	n	p u1 s
putes	n	p u1 - t ax s
quadern	n	k w ax - D E1 rr n
quadrar	n	k w ax - D r a1
quadrets	n	k w ax - D r E1 t s
quadrilàters	n	k w ax - D r i - l a1 - t ax rr s
quadro	n	k w a1 - D r u
quarter	n	k w ax rr - t e1
quatrecents	n	k w ax - t r ax - s e1 n s
queixa	n	k e1 - S ax
queixalades	n	k ax - S ax - l a1 - D ax s
queixalar	n	k ax - S ax - l a1
queixalo	n	k ax - S a1 - l u
queixals	n	k ax - S a1 l s
queixar	n	k ax - S a1
queixaves	n	k ax - S a1 - B ax s
queixen	n	k E1 - S ax n
queixes	n	k e1 - S ax s
quer	n	k E1 rr
qüestionar	n	k w ax s - t i - u - n a1
quilos	n	k i1 - l u s
quilowatt	n	k i - l u - B a1 t
quimera	n	k i - m e1 - r ax
quim	n	k i1 m
quintet	n	k i n - t E1 t
quiosc	n	k i - O1 s k
quir	n	k i1 rr
quiròfan	n	k i - r O1 - f ax n
quitxalla	n	k i t - S a1 - L ax
quocient	n	k w u - s i - e1 n
quota	n	k w O1 - t ax
quotes	n	k w O1 - t ax s
quotidianitat	n	k w u - t i - D i - ax - n i - t a1 t
rabassers	n	rr ax - B ax - s e1 s
rabat	n	rr ax - B a1 t
races	n	rr a1 - s ax s
racionalitat	n	rr ax - s i - u - n ax - l i - t a1 t
racions	n	rr ax - s i - o1 n s
racista	n	rr ax - s i1 s - t ax
raconet	n	rr ax - k u - n E1 t
radera	n	rr ax - D e1 - r ax
radioajudes	n	rr a - D i - u - ax - Z u1 - D ax s
radiografia	n	rr ax - D i - u - G r ax - f i1 - ax
radiòmetre	n	rr ax - D i - O1 - m ax - t r ax
radi	n	rr a1 - D i
ràfting	n	rr a1 f - t i N
raigràs	n	rr ax j - G r a1 s
rails	n	rr a1 j l s
rallaves	n	rr ax - L a1 - B ax s
rampoines	n	rr ax m - p O1 j - n ax s
rang	n	rr a1 N
ranuncle	n	rr ax - n u1 N - k l ax
ranures	n	rr ax - n u1 - r ax s
raonables	n	rr ax - u - n a1 b - b l ax s
raonadament	n	rr ax - u - n a - D ax - m e1 n
ràpidament	n	rr a - p i - D ax - m e1 n
raqueta	n	rr ax - k E1 - t ax
rasant	n	rr ax - z a1 n
raspall	n	rr ax s - p a1 L
raspalls	n	rr ax s - p a1 L s
rasposa	n	rr ax s - p o1 - z ax
ràster	n	rr a1 s - t ax
ratificava	n	rr ax - t i - f i - k a1 - B ax
ratllada	n	rr ax L - L a1 - D ax
ratllat	n	rr ax L - L a1 t
ratllin	n	rr a1 L - L i n
ratolins	n	rr ax - t u - l i1 n s
ratpenat	n	rr a t - p ax - n a1 t
ratpenats	n	rr a t - p ax - n a1 t s
raula	n	rr a1 uw - l ax
raval	n	rr ax - B a1 l
reafirmin	n	rr e - ax - f i1 rr - m i n
reagrupament	n	rr e - ax - G r u - p ax - m e1 n
realitzadora	n	rr e - ax - l i d - z ax - D o1 - r ax
reallotjar	n	rr e - ax - L u d - Z a1
realment	n	rr e - a l - m e1 n
rebaixar	n	rr ax - B ax - S a1
rebaixes	n	rr ax - B a1 - S ax s
rebel·lia	n	rr ax - B ax - l i1 - ax
rebentar	n	rr ax - B ax n - t a1
rebentat	n	rr ax - B ax n - t a1 t
rebombori	n	rr ax - B u m - b O1 - r i
reboti	n	rr ax - B O1 - t i
rebregat	n	rr ax - B r ax - G a1 t
rebregats	n	rr ax - B r ax - G a1 t s
recanvi	n	rr ax - k a1 m - b i
recaptació	n	rr ax - k ax p - t ax - s i - o1
recelosa	n	rr ax - s ax - l o1 - z ax
recentment	n	rr ax - s e m - m e1 n
recepcionista	n	rr ax - s ax p - s i - u - n i1 s - t ax
recepció	n	rr ax - s ax p - s i - o1
recepta	n	rr ax - s e1 p - t ax
receptes	n	rr ax - s e1 p - t ax s
receptiva	n	rr ax - s ax p - t i1 - B ax
reciclar	n	rr ax - s i - k l a1
recinte	n	rr ax - s i1 n - t ax
recipients	n	rr ax - s i - p i - e1 n s
reclamacions	n	rr ax - k l ax - m ax - s i - o1 n s
recobertes	n	rr ax - k u - B E1 rr - t ax s
recobria	n	rr ax - k u - B r i1 - ax
recomanable	n	rr ax - k u - m ax - n a1 b - b l ax
recomanacions	n	rr ax - k u - m ax - n ax - s i - o1 n s
recompte	n	rr ax - k o1 m - t ax
reconduir	n	rr ax - k u n - d u - i1
reconeixo	n	rr ax - k u - n E1 - S u
reconversió	n	rr ax - k u m - b ax rr - s i - o1
recopilació	n	rr ax - k u - p i - l ax - s i - o1
recordatoris	n	rr ax - k u r - D ax - t O1 - r i s
rècord	n	rr E1 - k u rr t
recrea	n	rr ax - k r e1 - ax
recrear	n	rr ax - k r e - a1
recreatius	n	rr ax - k r e - ax - t i1 uw s
recrema	n	rr ax - k r E1 - m ax
rec	n	rr e1 k
rector	n	rr ax k - t o1
recurrent	n	rr ax - k u - rr e1 n
redefinia	n	rr ax - D ax - f i - n i1 - ax
redemptora	n	rr ax - D ax m - t o1 - r ax
redimensioni	n	rr ax - D i - m ax n - s i - O1 - n i
redireccionar	n	rr ax - D i - r ax k - s i - u - n a1
redireccions	n	rr ax - D i - r ax k - s i - o1 n s
rèdit	n	rr E1 - D i t
reemborsarà	n	rr e - ax m - b u rr - s ax - r a1
reemissió	n	rr e - ax - m i - s i - o1
reencarnació	n	rr e - ax N - k ax rr - n ax - s i - o1
reescrit	n	rr e - ax s - k r i1 t
reexaminar	n	rr e - ax g - z ax - m i - n a1
reflexoteràpia	n	rr ax - f l ax k - s u - t ax - r a1 - p i - ax
refredament	n	rr ax - f r ax - D ax - m e1 n
refreda	n	rr ax - f r E1 - D ax
refredar	n	rr ax - f r ax - D a1
refredat	n	rr ax - f r ax - D a1 t
refrescant	n	rr ax - f r ax s - k a1 n
refrescants	n	rr ax - f r ax s - k a1 n s
refrescar	n	rr ax - f r ax s - k a1
refresco	n	rr ax - f r E1 s - k u
refrigeració	n	rr ax - f r i - Z ax - r ax - s i - o1
regadora	n	rr ax - G ax - D o1 - r ax
regalet	n	rr ax - G ax - l E1 t
regalimar	n	rr ax - G ax - l i - m a1
regalimaven	n	rr ax - G ax - l i - m a1 - B ax n
regal	n	rr ax - G a1 l
regals	n	rr ax - G a1 l s
regatejar	n	rr ax - G ax - t ax - Z a1
regidor	n	rr ax - Z i - D o1
regira	n	rr ax - Z i1 - r ax
regirar	n	rr ax - Z i - r a1
reguerol	n	rr ax - G ax - r O1 l
reguitzell	n	rr ax - G i d - z e1 L
regularitzar	n	rr ax - G u - l ax - r i d - z a1
regust	n	rr ax - G u1 s t
rehabilitació	n	rr e - ax - B i - l i - t ax - s i - o1
reietó	n	rr ax - y ax - t o1
reinetes	n	rr ax j - n E1 - t ax s
reiniciarà	n	rr ax - i - n i - s i - ax - r a1
reinicia	n	rr ax - i - n i - s i1 - ax
reintegrament	n	rr ax - i n - t ax - G r ax - m e1 n
reintenta	n	rr ax - i n - t e1 n - t ax
relaten	n	rr ax - l a1 - t ax n
relaxada	n	rr ax - l ax k - s a1 - D ax
relaxats	n	rr ax - l ax k - s a1 t s
religions	n	rr ax - l i - Z i - o1 n s
religió	n	rr ax - l i - Z i - o1
rellegeixes	n	rr ax - L ax - Z E1 - S ax s
rellegir	n	rr ax - L ax - Z i1
remanada	n	rr ax - m ax - n a1 - D ax
rememora	n	rr ax - m ax - m o1 - r ax
remenes	n	rr ax - m E1 - n ax s
remeno	n	rr ax - m E1 - n u
remescles	n	rr ax - m e1 s - k l ax s
remetrem	n	rr ax - m ax - t r E1 m
remitent	n	rr ax - m i - t e1 n
remolc	n	rr ax - m o1 l k
remordiments	n	rr ax - m u r - D i - m e1 n s
remouria	n	rr ax - m o uw - r i1 - ax
remugant	n	rr ax - m u - G a1 n
renaixentistes	n	rr ax - n ax - S ax n - t i1 s - t ax s
rencontre	n	rr ax N - k o1 n - t r ax
renda	n	rr e1 n - d ax
rendeix	n	rr ax n - d E1 S
renecs	n	rr ax - n e1 k s
renegrida	n	rr ax - n ax - G r i1 - D ax
renfe	n	rr e1 m - f ax
renovables	n	rr ax - n u - B a1 b - b l ax s
rentadora	n	rr ax n - t ax - D o1 - r ax
rentador	n	rr ax n - t ax - D o1
rentatge	n	rr ax n - t a1 d - Z ax
reordenar	n	rr ax - u r - D ax - n a1
repassar	n	rr ax - p ax - s a1
repassava	n	rr ax - p ax - s a1 - B ax
repassen	n	rr ax - p a1 - s ax n
repensar	n	rr ax - p ax n - s a1
repicar	n	rr ax - p i - k a1
repiquen	n	rr ax - p i1 - k ax n
replegada	n	rr ax - p l ax - G a1 - D ax
repliquem	n	rr ax - p l i - k E1 m
reportatge	n	rr ax - p u rr - t a1 d - Z ax
repostar	n	rr ax - p u s - t a1
reprimir	n	rr ax - p r i - m i1
reprimiu	n	rr ax - p r i - m i1 uw
reproductor	n	rr ax - p r u - D u k - t o1
repulsió	n	rr ax - p u l - s i - o1
requadre	n	rr ax - k w a1 - D r ax
rera	n	rr e1 - r ax
rere	n	rr e1 - r ax
resident	n	rr ax - z i - D e1 n
residus	n	rr ax - z i1 - D u s
resignadament	n	rr ax - z i g - n a - D ax - m e1 n
resigno	n	rr ax - z i1 g - n u
respatller	n	rr ax s - p ax L - L e1
respatllers	n	rr ax s - p ax L - L e1 s
respectables	n	rr ax s - p ax k - t a1 b - b l ax s
respectivament	n	rr ax s - p ax k - t i - B ax - m e1 n
respectuosament	n	rr ax s - p ax k - t u - o - z ax - m e1 n
responsabilitzaran	n	rr ax s - p u n - s ax - B i - l i d - z ax - r a1 n
ressentir	n	rr ax - s ax n - t i1
ressona	n	rr ax - s o1 - n ax
restallera	n	rr ax s - t ax - L e1 - r ax
restaurant	n	rr ax s - t ax uw - r a1 n
restaurants	n	rr ax s - t ax uw - r a1 n s
retallada	n	rr ax - t ax - L a1 - D ax
retallareu	n	rr ax - t ax - L ax - r E1 uw
retard	n	rr ax - t a1 rr t
rètols	n	rr E1 - t u l s
retratistes	n	rr ax - t r ax - t i1 s - t ax s
retrauria	n	rr ax - t r ax uw - r i1 - ax
retrau	n	rr ax - t r a1 uw
retrec	n	rr ax - t r E1 k
retrets	n	rr ax - t r e1 t s
retrocedir	n	rr ax - t r u - s ax - D i1
reüll	n	rr ax - u1 L
reus	n	rr E1 uw s
reverència	n	rr ax - B ax - r E1 n - s i - ax
revers	n	rr ax - B E1 rr s
revés	n	rr ax - B e1 s
revetlla	n	rr ax - B e1 L - L ax
revinclades	n	rr ax - B i N - k l a1 - D ax s
revisor	n	rr ax - B i - z o1
reviure	n	rr ax - B i1 uw - r ax
revolada	n	rr ax - B u - l a1 - D ax
revolt	n	rr ax - B O1 l
reykiavik	n	rr ax j - k i - ax - B i1 k
rialla	n	rr i - a1 - L ax
riallera	n	rr i - ax - L e1 - r ax
rialles	n	rr i - a1 - L ax s
ribagorça	n	rr i - B ax - G o1 rr - s ax
ricard	n	rr i - k a1 rr t
ridícula	n	rr i - D i1 - k u - l ax
ridícules	n	rr i - D i1 - k u - l ax s
ridícul	n	rr i - D i1 - k u l
ridículs	n	rr i - D i1 - k u l s
rierols	n	rr i - ax - r O1 l s
riga	n	rr i1 - G ax
rigorosament	n	rr i - G u - r o - z ax - m e1 n
riitta	n	rr i1 j - t ax
rioja	n	rr i - O1 - Z ax
ripollet	n	rr i - p u - L E1 t
ripoll	n	rr i - p o1 L
rissos	n	rr i1 - s u s
rítmica	n	rr i1 d - m i - k ax
rítmics	n	rr i1 d - m i k s
ritual	n	rr i - t u - a1 l
riuada	n	rr i - w a1 - D ax
rivals	n	rr i - B a1 l s
robe	n	rr o1 - B ax
robert	n	rr u - B E1 rr t
robòtica	n	rr u - B O1 - t i - k ax
robots	n	rr u - B O1 t s
rocafort	n	rr O - k ax - f O1 rr t
rock	n	rr O1 k
rodalies	n	rr u - D ax - l i1 - ax s
rodanxes	n	rr u - D a1 n - S ax s
rodolant	n	rr u - D u - l a1 n
rodolen	n	rr u - D O1 - l ax n
rogenques	n	rr u - Z E1 N - k ax s
roger	n	rr u - Z e1
rol	n	rr O1 l
romanticisme	n	rr u - m ax n - t i - s i1 z - m ax
roma	n	rr o1 - m ax
rom	n	rr o1 m
ronca	n	rr o1 N - k ax
rondalla	n	rr u n - d a1 - L ax
ronda	n	rr o1 n - d ax
rondava	n	rr u n - d a1 - B ax
ronden	n	rr o1 n - d ax n
ronyons	n	rr u - J o1 n s
rosalia	n	rr u - z ax - l i1 - ax
rosana	n	rr u - z a1 - n ax
rossellonesa	n	rr u - s ax - L u - n E1 - z ax
rostre	n	rr O1 s - t r ax
rostres	n	rr O1 s - t r ax s
rotació	n	rr u - t ax - s i - o1
rotllana	n	rr u L - L a1 - n ax
rotllo	n	rr O1 L - L u
rotllos	n	rr O1 L - L u s
rotonda	n	rr u - t o1 n - d ax
rovellat	n	rr u - B ax - L a1 t
rovellons	n	rr u - B ax - L o1 n s
rovira	n	rr u - B i1 - r ax
rubí	n	rr u - B i1
rubles	n	rr u1 b - b l ax s
rugbi	n	rr u1 g - b i
rugosa	n	rr u - G o1 - z ax
rugositat	n	rr u - G u - z i - t a1 t
rugós	n	rr u - G o1 s
ruleta	n	rr u - l E1 - t ax
rumiador	n	rr u - m i - ax - D o1
runes	n	rr u1 - n ax s
rúpies	n	rr u1 - p i - ax s
rus	n	rr u1 s
russa	n	rr u1 - s ax
russes	n	rr u1 - s ax s
rússia	n	rr u1 - s i - ax
rústega	n	rr u1 s - t ax - G ax
ruth	n	rr u1 t
rutinari	n	rr u - t i - n a1 - r i
rutina	n	rr u - t i1 - n ax
ruti	n	rr u1 - t i
rutllar	n	rr u L - L a1
sabadell	n	s ax - B ax - D e1 L
sabater	n	s ax - B ax - t e1
sabatilles	n	s ax - B ax - t i1 - L ax s
sabonets	n	s ax - B u - n E1 t s
sabor	n	s ax - B o1 rr
sacrificant	n	s ax - k r i - f i - k a1 n
sacrificat	n	s ax - k r i - f i - k a1 t
sacrificats	n	s ax - k r i - f i - k a1 t s
sacrificis	n	s ax - k r i - f i1 - s i s
sàdics	n	s a1 - D i k s
sàdiques	n	s a1 - D i - k ax s
sahrauí	n	s ax - rr ax - w i1
salari	n	s ax - l a1 - r i
saldo	n	s a1 l - d u
saleta	n	s ax - l E1 - t ax
saliva	n	s ax - l i1 - B ax
salou	n	s ax - l O1 uw
salpebra	n	s ax l - p e1 - B r ax
salsa	n	s a1 l - s ax
salsitxes	n	s ax l - s i1 t - S ax s
saludables	n	s ax - l u - D a1 b - b l ax s
salutacions	n	s ax - l u - t ax - s i - o1 n s
salvaguardar	n	s a l - B ax - G w ax r - D a1
salvatjades	n	s ax l - B ax d - Z a1 - D ax s
samarreta	n	s ax - m ax - rr E1 - t ax
samarretes	n	s ax - m ax - rr E1 - t ax s
samland	n	s ax m - l a1 n
sandàlies	n	s ax n - d a1 - l i - ax s
sandra	n	s a1 n - d r ax
sandvitx	n	s ax n d - b i1 tS
santander	n	s a n - t ax n - d e1 rr
santer	n	s ax n - t e1
santiago	n	s ax n - t i - a1 - G u
santi	n	s a1 n - t i
sao	n	s a1 - u
sapes	n	s a1 - p ax s
sapiens	n	s ax - p i - E1 n s
saqueig	n	s ax - k E1 tS
saquejadors	n	s ax - k ax - Z ax - D o1 s
saragossa	n	s ax - r ax - G o1 - s ax
sara	n	s a1 - r ax
sarcòfag	n	s ax rr - k O1 - f ax k
sardana	n	s ax r - D a1 - n ax
sardanes	n	s ax r - D a1 - n ax s
sargantana	n	s ax r - G ax n - t a1 - n ax
sargantanes	n	s ax r - G ax n - t a1 - n ax s
sarganta	n	s ax r - G a1 n - t ax
sarrià	n	s ax - rr i - a1
sarsuela	n	s ax rr - s u - E1 - l ax
sastre	n	s a1 s - t r ax
satèl·lit	n	s ax - t E1 - l i t
satisfactòriament	n	s ax - t i s - f ax k - t O - r i - ax - m e1 n
satriani	n	s ax - t r i - a1 - n i
saudí	n	s ax uw - D i1
saviesa	n	s ax - B i - E1 - z ax
saxòfon	n	s ax k - s O1 - f u n
saxo	n	s a1 k - s u
seattle	n	s e - a1 l - l ax
sebastià	n	s ax - B ax s - t i - a1
secretisme	n	s ax - k r ax - t i1 z - m ax
secta	n	s E1 k - t ax
secundaria	n	s ax - k u n - d ax - r i1 - ax
sedentari	n	s ax - D ax n - t a1 - r i
seducció	n	s ax - D u k - s i - o1
seductor	n	s ax - D u k - t o1
seduir	n	s ax - D u - i1
seduí	n	s ax - D u - i1
segarra	n	s ax - G a1 - rr ax
segellada	n	s ax - Z ax - L a1 - D ax
segrià	n	s ax - G r i - a1
seguidament	n	s ax - G i - D ax - m e1 n
seguiment	n	s ax - G i - m e1 n
segurament	n	s ax - G u - r ax - m e1 n
seients	n	s ax - y e1 n s
seitons	n	s ax j - t o1 n s
seleccionada	n	s ax - l ax k - s i - u - n a1 - D ax
seleccionar	n	s ax - l ax k - s i - u - n a1
selecciona	n	s ax - l ax k - s i - o1 - n ax
seleccionat	n	s ax - l ax k - s i - u - n a1 t
seleccionats	n	s ax - l ax k - s i - u - n a1 t s
seleccionem	n	s ax - l ax k - s i - u - n E1 m
selecciones	n	s ax - l ax k - s i - o1 - n ax s
seleccioneu	n	s ax - l ax k - s i - u - n E1 uw
seleccionin	n	s ax - l ax k - s i - o1 - n i n
seleccioni	n	s ax - l ax k - s i - o1 - n i
selecta	n	s ax - l E1 k - t ax
selectiva	n	s ax - l ax k - t i1 - B ax
selector	n	s ax - l ax k - t o1
selvas	n	s E1 l - B ax s
semàfor	n	s ax - m a1 - f u rr
semàfors	n	s ax - m a1 - f u rr s
sembrat	n	s ax m - b r a1 t
semicircumferència	n	s E - m i - s i rr - k u m - f ax - r E1 n - s i - ax
semideserta	n	s E - m i - D ax - z E1 rr - t ax
semifetal	n	s E - m i - f ax - t a1 l
semipública	n	s E - m i - p u1 - B l i - k ax
semitons	n	s E - m i - t O1 n s
semitò	n	s E - m i - t O1
sender	n	s ax n - d e1
senegalès	n	s ax - n ax - G ax - l E1 s
senglars	n	s ax N - g l a1 s
sensacional	n	s ax n - s ax - s i - u - n a1 l
sensibilització	n	s ax n - s i - B i - l i d - z ax - s i - o1
sensitiva	n	s ax n - s i - t i1 - B ax
sensuals	n	s ax n - s u - a1 l s
senyala	n	s ax - J a1 - l ax
senyalitzada	n	s ax - J ax - l i d - z a1 - D ax
senyalitzar	n	s ax - J ax - l i d - z a1
senyorial	n	s ax - J u - r i - a1 l
senyorials	n	s ax - J u - r i - a1 l s
separadament	n	s ax - p ax - r a - D ax - m e1 n
sepulcral	n	s ax - p u l - k r a1 l
sequaços	n	s ax - k w a1 - s u s
seqüeles	n	s ax - k w E1 - l ax s
serenos	n	s ax - r E1 - n u s
sergio	n	s ax rr - Z i1 - u
sergi	n	s E1 rr - Z i
sèriament	n	s E - r i - ax - m e1 n
seriosament	n	s ax - r i - o - z ax - m e1 n
seriositat	n	s ax - r i - u - z i - t a1 t
serrat	n	s ax - rr a1 t
serro	n	s E1 - rr u
sers	n	s e1 rr s
servents	n	s ax r - B e1 n s
servidor	n	s ax r - B i - D o1
servidors	n	s ax r - B i - D o1 s
setmanalment	n	s ax m - m ax - n a l - m e1 n
sevillà	n	s ax - B i - L a1
sevilla	n	s ax - B i1 - L ax
sevi	n	s E1 - B i
sexi	n	s e1 k - s i
sexistes	n	s ax k - s i1 s - t ax s
sicilians	n	s i - s i - l i - a1 n s
sicília	n	s i - s i1 - l i - ax
sida	n	s i1 - D ax
sigil·losament	n	s i - Z i - l o - z ax - m e1 n
signar	n	s i g - n a1
signi	n	s i1 g - n i
sigut	n	s i - G u1 t
silenciosa	n	s i - l ax n - s i - o1 - z ax
silencioses	n	s i - l ax n - s i - o1 - z ax s
silueta	n	s i - l u - E1 - t ax
silvestres	n	s i l - B e1 s - t r ax s
sílvia	n	s i1 l - B i - ax
simetria	n	s i - m ax - t r i1 - ax
similitud	n	s i - m i - l i - t u1 t
simi	n	s i1 - m i
simpàtic	n	s i m - p a1 - t i k
simplificar	n	s i m - p l i - f i - k a1
simplifica	n	s i m - p l i - f i1 - k ax
simulació	n	s i - m u - l ax - s i - o1
simular	n	s i - m u - l a1
simultàniament	n	s i - m u l - t a - n i - ax - m e1 n
sinagogues	n	s i - n ax - G O1 - G ax s
sincerament	n	s i n - s e - r ax - m e1 n
sincera	n	s i n - s e1 - r ax
sindicalisme	n	s i n - d i - k ax - l i1 z - m ax
síndic	n	s i1 n - d i k
síndics	n	s i1 n - d i k s
sinonímia	n	s i - n u - n i1 - m i - ax
sintagma	n	s i n - t a1 g - m ax
sintetitzadors	n	s i n - t ax - t i d - z ax - D o1 s
sintoista	n	s i n - t u - i1 s - t ax
sinus	n	s i1 - n u s
sió	n	s i - o1
sistematitzada	n	s i s - t ax - m ax - t i d - z a1 - D ax
sitges	n	s i1 d - Z ax s
siurana	n	s i uw - r a1 - n ax
skopje	n	s k o1 b - Z ax
sobirà	n	s u - B i - r a1
sobrava	n	s u - B r a1 - B ax
sobrecàrrega	n	s o - B r ax - k a1 - rr ax - G ax
sobrecarregava	n	s o - B r ax - k ax - rr ax - G a1 - B ax
sobreescriu	n	s o - B r ax s - k r i1 uw
sobrenom	n	s o - B r ax - n O1 m
sobren	n	s o1 - B r ax n
sobrepassat	n	s o - B r ax - p ax - s a1 t
sobrepassi	n	s o - B r ax - p a1 - s i
sobresou	n	s o - B r ax - s o1 uw
sobressin	n	s o - B r ax - s i1 n
sobresurtin	n	s o - B r ax - s u1 rr - t i n
sobrevivent	n	s o - B r ax - B i - B e1 n
sobtadament	n	s u p - t a - D ax - m e1 n
sobtar	n	s u p - t a1
sobte	n	s o1 p - t ax
sobtin	n	s O1 p - t i n
sobto	n	s o1 p - t u
socarrimat	n	s u - k ax - rr i - m a1 t
socialització	n	s u - s i - ax - l i d - z ax - s i - o1
sociolaboral	n	s O - s i - u - l ax - B u - r a1 l
soci	n	s O1 - s i
sofre	n	s o1 - f r ax
solament	n	s O - l ax - m e1 n
solca	n	s o1 l - k ax
soledat	n	s u - l ax - D a1 t
sol·licitada	n	s u - l i - s i - t a1 - D ax
sol·licitants	n	s u - l i - s i - t a1 n s
sol·licitar	n	s u - l i - s i - t a1
sol·licita	n	s u - l i - s i1 - t ax
sol·licitat	n	s u - l i - s i - t a1 t
sol·licitem	n	s u - l i - s i - t E1 m
sol·liciten	n	s u - l i - s i1 - t ax n
sol·licituds	n	s u - l i - s i - t u1 t s
sol·licitud	n	s u - l i - s i - t u1 t
solo	n	s O1 - l u
solsona	n	s u l - s o1 - n ax
solsonès	n	s u l - s u - n E1 s
solstici	n	s u l s - t i1 - s i
solters	n	s u l - t e1 s
solucionaria	n	s u - l u - s i - u - n ax - r i1 - ax
solucionar	n	s u - l u - s i - u - n a1
somicava	n	s u - m i - k a1 - B ax
somnífer	n	s u m - n i1 - f ax rr
somnolència	n	s u m - n u - l E1 n - s i - ax
sonores	n	s u - n o1 - r ax s
sonoritat	n	s u - n u - r i - t a1 t
sonors	n	s u - n o1 rr s
sordmuda	n	s u rr d - m u1 - D ax
sòria	n	s O1 - r i - ax
sorna	n	s o1 rr - n ax
sorneguera	n	s u rr - n ax - G e1 - r ax
sorneguer	n	s u rr - n ax - G e1
sorollets	n	s u - r u - L E1 t s
sorollet	n	s u - r u - L E1 t
sorreta	n	s u - rr E1 - t ax
sorribes	n	s u - rr i1 - B ax s
sorrut	n	s u - rr u1 t
sorteig	n	s u rr - t E1 tS
sortejar	n	s u rr - t ax - Z a1
sospesa	n	s u s - p e1 - z ax
sospesat	n	s u s - p ax - z a1 t
sospesen	n	s u s - p e1 - z ax n
sospitosa	n	s u s - p i - t o1 - z ax
sostenible	n	s u s - t ax - n i1 b - b l ax
sostenidor	n	s u s - t ax - n i - D o1
soterrani	n	s u - t ax - rr a1 - n i
soulier	n	s o uw - l i - e1
sovi	n	s O1 - B i
soy	n	s O1 j
spencer	n	s p ax n - s e1
stewart	n	s t ax - B a1 rr t
suar	n	s u - a1
suaument	n	s u - a uw - m e1 n
suavitat	n	s u - ax - B i - t a1 t
suavitzen	n	s u - ax - B i1 d - z ax n
subcaracterístiques	n	s u p - k ax - r ax k - t ax - r i1 s - t i - k ax s
subclassificació	n	s u p - k l ax - s i - f i - k ax - s i - o1
subdirectoris	n	s u b - d i - r ax k - t O1 - r i s
súbdits	n	s u1 b - d i t s
subfusell	n	s u p - f u - z e1 L
subgovernador	n	s u b - g u - B ax rr - n ax - D o1
subgrup	n	s u b - g r u1 p
subhasta	n	s u - B a1 s - t ax
subhastat	n	s u - B ax s - t a1 t
submenú	n	s u b - m ax - n u1
submergir	n	s u b - m ax rr - Z i1
subministressin	n	s u b - m i - n i s - t r e1 - s i n
subproductes	n	s u p - p r u - D u1 k - t ax s
subscripció	n	s u p s - k r i p - s i - o1
subsector	n	s u p - s ax k - t o1
subsidiàries	n	s u p - s i - D i - a1 - r i - ax s
subsidi	n	s u p - s i1 - D i
subsòl	n	s u p - s O1 l
subtilment	n	s u p - t i l - m e1 n
subtítols	n	s u p - t i1 - t u l s
suburbis	n	s u - B u1 r - B i s
subvenció	n	s u b - b ax n - s i - o1
subversió	n	s u b - b ax rr - s i - o1
successos	n	s u k - s e1 - s u s
suècia	n	s u - E1 - s i - ax
suficientment	n	s u - f i - s i - e m - m e1 n
suïssa	n	s u - i1 - s ax
suïssos	n	s u - i1 - s u s
sunnites	n	s u n - n i1 - t ax s
superflu	n	s u - p E1 rr - f l u
superherois	n	s u - p ax - r ax - r O1 j s
supernoves	n	s u - p ax rr - n O1 - B ax s
súpers	n	s u1 - p ax s
supervisat	n	s u - p ax r - B i - z a1 t
supervisora	n	s u - p ax r - B i - z o1 - r ax
supervivents	n	s u - p ax r - B i - B e1 n s
supervivent	n	s u - p ax r - B i - B e1 n
suplement	n	s u - p l ax - m e1 n
surar	n	s u - r a1
sura	n	s u1 - r ax
surf	n	s u1 rr f
suro	n	s u1 - r u
surrealisme	n	s u - rr e - ax - l i1 z - m ax
suspendre	n	s u s - p E1 n - d r ax
sydney	n	s i d - n E1 j
tàbac	n	t a1 - B ax k
tabarra	n	t ax - B a1 - rr ax
tabuladors	n	t ax - B u - l ax - D o1 s
tacar	n	t ax - k a1
taciturn	n	t ax - s i - t u1 rr n
tacte	n	t a1 k - t ax
tailàndia	n	t ax j - l a1 n - d i - ax
taipei	n	t ax j - p E1 j
taiwan	n	t ax j - B a1 n
talgo	n	t a1 l - G u
talladet	n	t a - L ax - D E1 t
tallafoc	n	t a - L ax - f O1 k
tallet	n	t ax - L E1 t
talment	n	t a l - m e1 n
tamborils	n	t ax m - b u - r i1 l s
tambors	n	t ax m - b o1 s
tangible	n	t ax n - Z i1 b - b l ax
tapiada	n	t ax - p i - a1 - D ax
tapisseria	n	t ax - p i - s ax - r i1 - ax
taquilla	n	t ax - k i1 - L ax
taràntules	n	t ax - r a1 n - t u - l ax s
tarden	n	t a1 r - D ax n
tarifària	n	t ax - r i - f a1 - r i - ax
tarifa	n	t ax - r i1 - f ax
tarifes	n	t ax - r i1 - f ax s
tarragona	n	t ax - rr ax - G o1 - n ax
tarragonès	n	t ax - rr ax - G u - n E1 s
tàrrega	n	t a1 - rr ax - G ax
tartamudejant	n	t ax rr - t ax - m u - D ax - Z a1 n
tastar	n	t ax s - t a1
tasta	n	t a1 s - t ax
tatuar	n	t ax - t u - a1
tatuatges	n	t ax - t u - a1 d - Z ax s
tatxa	n	t a1 t - S ax
tauler	n	t ax uw - l e1
taüll	n	t ax - u1 L
taüts	n	t ax - u1 t s
tavernari	n	t ax - B ax rr - n a1 - r i
taxi	n	t a1 k - s i
teatral	n	t e - ax - t r a1 l
tèbia	n	t E1 - B i - ax
tecla	n	t e1 - k l ax
teclegen	n	t ax - k l E1 - Z ax n
teclegi	n	t ax - k l E1 - Z i
tecleig	n	t ax - k l E1 tS
tecles	n	t e1 - k l ax s
tecnocientífic	n	t E g - n u - s i - ax n - t i1 - f i k
tecnològics	n	t ax g - n u - l O1 - Z i k s
tecnològic	n	t ax g - n u - l O1 - Z i k
tecnologies	n	t ax g - n u - l u - Z i1 - ax s
tediosament	n	t ax - D i - o - z ax - m e1 n
tediosa	n	t ax - D i - o1 - z ax
tedi	n	t E1 - D i
tegucigalpa	n	t ax - G u - s i - G a1 l - p ax
teies	n	t E1 - y ax s
teleassistència	n	t E - l ax - s i s - t E1 n - s i - ax
teledirigit	n	t E - l ax - D i - r i - Z i1 t
telefèric	n	t ax - l ax - f E1 - r i k
telefònica	n	t E - l ax - f O1 - n i - k ax
telefònic	n	t ax - l ax - f O1 - n i k
telefòniques	n	t E - l ax - f O1 - n i - k ax s
telèfons	n	t ax - l E1 - f u n s
telèfon	n	t ax - l E1 - f u n
telemàtica	n	t ax - l ax - m a1 - t i - k ax
telepàtica	n	t E - l ax - p a1 - t i - k ax
telepàtic	n	t ax - l ax - p a1 - t i k
telescombraries	n	t E - l ax s - k u m - b r ax - r i1 - ax s
telescopi	n	t ax - l ax s - k O1 - p i
tele	n	t E1 - l ax
televisius	n	t ax - l ax - B i - z i1 uw s
televisiu	n	t ax - l ax - B i - z i1 uw
televisiva	n	t ax - l ax - B i - z i1 - B ax
televisor	n	t ax - l ax - B i - z o1
teló	n	t ax - l o1
temaris	n	t ax - m a1 - r i s
temibles	n	t ax - m i1 b - b l ax s
temperaven	n	t ax m - p ax - r a1 - B ax n
templers	n	t ax m - p l e1 s
temporalment	n	t ax m - p u - r a l - m e1 n
temptats	n	t ax m - t a1 t s
tendals	n	t ax n - d a1 l s
tenda	n	t e1 n - d ax
tendrament	n	t E n - d r ax - m e1 n
tendresa	n	t ax n - d r E1 - z ax
tenerife	n	t ax - n ax - r i1 - f ax
tenis	n	t E1 - n i s
tennis	n	t E1 n - n i s
tenyidores	n	t ax - J i - D o1 - r ax s
tenyir	n	t ax - J i1
tenyit	n	t ax - J i1 t
teòleg	n	t ax - O1 - l ax k
tequila	n	t ax - k i1 - l ax
terapeuta	n	t ax - r ax - p E1 uw - t ax
tercet	n	t ax rr - s E1 t
terciari	n	t ax rr - s i - a1 - r i
teresa	n	t ax - r E1 - z ax
tergiversació	n	t ax rr - Z i - B ax rr - s ax - s i - o1
terminals	n	t ax rr - m i - n a1 l s
termites	n	t ax rr - m i1 - t ax s
terraqüi	n	t ax - rr a1 - k w i
terrasa	n	t E1 - rr ax - s ax
terriblement	n	t ax - rr i b - b l ax - m e1 n
terrible	n	t ax - rr i1 b - b l ax
terrícoles	n	t ax - rr i1 - k u - l ax s
terrissaires	n	t ax - rr i - s a1 j - r ax s
terrorífiques	n	t ax - rr u - r i1 - f i - k ax s
terrorisme	n	t ax - rr u - r i1 z - m ax
terrossos	n	t ax - rr O1 - s u s
tertúlies	n	t ax rr - t u1 - l i - ax s
testa	n	t e1 s - t ax
tètric	n	t E1 - t r i k
teules	n	t E1 uw - l ax s
textuals	n	t ax k s - t u - a1 l s
textures	n	t ax k s - t u1 - r ax s
thyssen	n	t i1 - s ax n
tibar	n	t i - B a1
tieta	n	t i - E1 - t ax
tiet	n	t i - E1 t
tigres	n	t i1 - G r ax s
timbales	n	t i m - b a1 - l ax s
tímidament	n	t i - m i - D ax - m e1 n
tinerfenya	n	t i - n ax rr - f E1 - J ax
tinta	n	t i1 n - t ax
tio	n	t i1 - u
tipifica	n	t i - p i - f i1 - k ax
tirallonga	n	t i - r ax - L o1 N - g ax
tirallongues	n	t i - r ax - L o1 N - g ax s
tirana	n	t i - r a1 - n ax
tiretes	n	t i - r E1 - t ax s
tiros	n	t i1 - r u s
tisores	n	t i - z o1 - r ax s
titelles	n	t i - t e1 - L ax s
tiu	n	t i1 uw
tivissa	n	t i - B i1 - s ax
tobogan	n	t u - B u - G a1 n
tòfones	n	t O1 - f u - n ax s
toia	n	t O1 - y ax
tomb	n	t o1 m
tom	n	t o1 m
tongades	n	t u N - g a1 - D ax s
tonto	n	t o1 n - t u
topògraf	n	t u - p O1 - G r ax f
torben	n	t o1 r - B ax n
torero	n	t u - r e1 - r u
torí	n	t u - r i1
torneig	n	t u rr - n E1 tS
toro	n	t O1 - r u
torrat	n	t u - rr a1 t
torredembarra	n	t o - rr ax - D ax m - b a1 - rr ax
tortes	n	t O1 rr - t ax s
tortosa	n	t u rr - t o1 - z ax
tortuga	n	t u rr - t u1 - G ax
tortugues	n	t u rr - t u1 - G ax s
torturadores	n	t u rr - t u - r ax - D o1 - r ax s
torturat	n	t u rr - t u - r a1 t
torturava	n	t u rr - t u - r a1 - B ax
tortures	n	t u rr - t u1 - r ax s
tossuda	n	t u - s u1 - D ax
tossuderia	n	t u - s u - D ax - r i1 - ax
totalment	n	t u - t a l - m e1 n
totxanes	n	t u t - S a1 - n ax s
totxo	n	t o1 t - S u
tour	n	t O1 uw rr
tovallons	n	t u - B ax - L o1 n s
tovalló	n	t u - B ax - L o1
tova	n	t o1 - B ax
toves	n	t O1 - B ax s
tracció	n	t r ax k - s i - o1
tràfec	n	t r a1 - f ax k
traficants	n	t r ax - f i - k a1 n s
traficant	n	t r ax - f i - k a1 n
tragèdia	n	t r ax - Z E1 - D i - ax
trago	n	t r a1 - G u
traïcions	n	t r ax - i - s i - o1 n s
traïció	n	t r ax - i - s i - o1
traïda	n	t r ax - i1 - D ax
traïdors	n	t r ax - i - D o1 s
trama	n	t r a1 - m ax
tramitació	n	t r ax - m i - t ax - s i - o1
tramitar	n	t r ax - m i - t a1
tramiten	n	t r ax - m i1 - t ax n
tràmits	n	t r a1 - m i t s
tràmit	n	t r a1 - m i t
tramoia	n	t r ax - m O1 - y ax
trampa	n	t r a1 m - p ax
trampejar	n	t r ax m - p ax - Z a1
tranquilitzar	n	t r ax N - k i - l i d - z a1
tranquil·lament	n	t r ax N - k i - l ax - m e1 n
tranquil·litat	n	t r ax N - k i - l i - t a1 t
tranquil·litzar	n	t r ax N - k i - l i d - z a1
transbordaments	n	t r ax n z - B u r - D ax - m e1 n s
transbordament	n	t r ax n z - B u r - D ax - m e1 n
transbord	n	t r ax n z - B o1 rr t
transcendentals	n	t r ax - s ax n - d ax n - t a1 l s
transformadors	n	t r ax n s - f u rr - m ax - D o1 s
transformador	n	t r ax n s - f u rr - m ax - D o1
transgènics	n	t r ax n - Z E1 - n i k s
transitava	n	t r ax n - z i - t a1 - B ax
transmissibles	n	t r ax n z - m i - s i1 b - b l ax s
transoceànic	n	t r a n - z u - s e - a1 - n i k
transparència	n	t r ax n s - p ax - r E1 n - s i - ax
transvasament	n	t r ax n z - B ax - z ax - m e1 n
traquetreig	n	t r a - k ax - t r E1 tS
trasbalsat	n	t r ax z - B ax l - s a1 t
traspassar	n	t r ax s - p ax - s a1
traspassat	n	t r ax s - p ax - s a1 t
traspassen	n	t r ax s - p a1 - s ax n
trasplantessin	n	t r ax s - p l ax n - t e1 - s i n
traumatologia	n	t r ax uw - m ax - t u - l u - Z i1 - ax
travessera	n	t r ax - B ax - s e1 - r ax
traves	n	t r a1 - B ax s
tremolor	n	t r ax - m u - l o1
tremolosa	n	t r ax - m u - l o1 - z ax
trempat	n	t r ax m - p a1 t
tremp	n	t r e1 m
trena	n	t r E1 - n ax
trencaclosques	n	t r E N - k ax - k l O1 s - k ax s
trencadisses	n	t r ax N - k ax - D i1 - s ax s
trepants	n	t r ax - p a1 n s
trepidant	n	t r ax - p i - D a1 n
trepig	n	t r ax - p i1 tS
trescar	n	t r ax s - k a1
treurem	n	t r ax uw - r E1 m
triangles	n	t r i - a1 N - g l ax s
triangle	n	t r i - a1 N - g l ax
trias	n	t r i1 - ax s
tributaris	n	t r i - B u - t a1 - r i s
trigonomètriques	n	t r i - G u - n u - m E1 - t r i - k ax s
trilingües	n	t r i - l i1 N - g w ax s
trinitari	n	t r i - n i - t a1 - r i
trinitat	n	t r i - n i - t a1 t
trinxades	n	t r i n - S a1 - D ax s
triomfalistes	n	t r i - u m - f ax - l i1 s - t ax s
triomfalment	n	t r i - u m - f a l - m e1 n
triomfar	n	t r i - u m - f a1
triomfi	n	t r i - O1 m - f i
trípode	n	t r i1 - p u - D ax
tríptic	n	t r i1 p - t i k
tristany	n	t r i s - t a1 J
tristor	n	t r i s - t o1
trobadoresca	n	t r u - B ax - D u - r E1 s - k ax
trodheim	n	t r u - D E1 j m
trofeu	n	t r u - f E1 uw
trompeta	n	t r u m - p E1 - t ax
trona	n	t r O1 - n ax
tronat	n	t r u - n a1 t
trontolla	n	t r u n - t o1 - L ax
tron	n	t r O1 n
tronxos	n	t r o1 n - S u s
trossejar	n	t r u - s ax - Z a1
trossets	n	t r u - s E1 t s
trosset	n	t r u - s E1 t
truita	n	t r u1 j - t ax
truites	n	t r u1 j - t ax s
tsars	n	ts a1 rr s
tuba	n	t u1 - B ax
tubs	n	t u1 p s
tub	n	t u1 p
tulaines	n	t u - l a1 j - n ax s
túnel	n	t u1 - n ax l
tunis	n	t u1 - n i s
turcmans	n	t u rr g - m a1 n s
turc	n	t u1 rr k
turista	n	t u - r i1 s - t ax
turistes	n	t u - r i1 s - t ax s
txa	n	tS a1
txecs	n	tS E1 k s
txec	n	tS E1 k
txetxènia	n	tS ax t - S E1 - n i - ax
uafse	n	w a1 f - s ax
ubicacions	n	u - B i - k ax - s i - o1 n s
ubicació	n	u - B i - k ax - s i - o1
ubicats	n	u - B i - k a1 t s
udol	n	u - D o1 l
uganda	n	u - G a1 n - d ax
ullals	n	u - L a1 l s
ulldemol	n	u L - d ax - m O1 l
ulleres	n	u - L e1 - r ax s
ullets	n	u - L E1 t s
ultrafiltració	n	u l - t r ax - f i l - t r ax - s i - o1
unça	n	u1 n - s ax
unesco	n	u - n E1 s - k u
únicament	n	u - n i - k ax - m e1 n
unix	n	u - n i1 k s
urbanisme	n	u r - B ax - n i1 z - m ax
urbanístics	n	u r - B ax - n i1 s - t i k s
urbanístic	n	u r - B ax - n i1 s - t i k
urgència	n	u rr - Z E1 n - s i - ax
urgències	n	u rr - Z E1 n - s i - ax s
urgentment	n	u rr - Z e m - m e1 n
urna	n	u1 rr - n ax
urnes	n	u1 rr - n ax s
uruguaià	n	u - r u - G w ax - y a1
utòpica	n	u - t O1 - p i - k ax
utopies	n	u - t u - p i1 - ax s
vacances	n	b ax - k a1 n - s ax s
vaduz	n	b ax - D u1 s
vagabund	n	b ax - G ax - B u1 n
vagament	n	b a - G ax - m e1 n
vagó	n	b ax - G o1
vagons	n	b ax - G o1 n s
vaivé	n	b a j - B e1
valència	n	b ax - l E1 n - s i - ax
valeri	n	b ax - l E1 - r i
validació	n	b ax - l i - D ax - s i - o1
valladolid	n	b ax - L ax - D u - l i1 t
vallgorguina	n	b ax L - G u r - G i1 - n ax
vampir	n	b ax m - p i1 rr
vandàlics	n	b ax n - d a1 - l i k s
vaquers	n	b ax - k e1 s
vaques	n	b a1 - k ax s
varela	n	b ax - r E1 - l ax
varem	n	b ax - r E1 m
vàren	n	b a1 - r ax n
varen	n	b a1 - r ax n
varsòvia	n	b ax rr - s O1 - B i - ax
vector	n	b ax k - t o1
vehemència	n	b ax - ax - m E1 n - s i - ax
vehiculada	n	b ax - i - k u - l a1 - D ax
veiessiu	n	b ax - y ax - s i1 uw
vellesa	n	b ax - L E1 - z ax
velleta	n	b ax - L E1 - t ax
vellet	n	b ax - L E1 t
velluga	n	b ax - L u1 - G ax
vendrell	n	b ax n - d r e1 L
veneçuela	n	b ax - n ax - s u - E1 - l ax
venedor	n	b ax - n ax - D o1
venedors	n	b ax - n ax - D o1 s
venjança	n	b ax n - Z a1 n - s ax
ventafocs	n	b e n - t ax - f O1 k s
ventes	n	b e1 n - t ax s
ventura	n	b ax n - t u1 - r ax
venus	n	b E1 - n u s
verament	n	b e - r ax - m e1 n
verbalment	n	b ax r - B a l - m e1 n
verdós	n	b ax r - D o1 s
verdosos	n	b ax r - D o1 - z u s
verdura	n	b ax r - D u1 - r ax
veredicte	n	b ax - r ax - D i1 k - t ax
vergés	n	b ax rr - Z e1 s
vergonyós	n	b ax r - G u - J o1 s
verídic	n	b ax - r i1 - D i k
verificació	n	b ax - r i - f i - k ax - s i - o1
vermellosos	n	b ax rr - m ax - L o1 - z u s
verne	n	b E1 rr - n ax
verneda	n	b ax rr - n E1 - D ax
verres	n	b e1 - rr ax s
versiona	n	b ax rr - s i - o1 - n ax
vertaderes	n	b ax rr - t ax - D e1 - r ax s
vertigen	n	b ax rr - t i1 - Z ax n
vestidor	n	b ax s - t i - D o1
vestuari	n	b ax s - t u - a1 - r i
vestuaris	n	b ax s - t u - a1 - r i s
veterans	n	b ax - t ax - r a1 n s
veterinari	n	b ax - t ax - r i - n a1 - r i
vexat	n	b ax k - s a1 t
viagra	n	b i - a1 - G r ax
viarany	n	b i - ax - r a1 J
vibracions	n	b i - B r ax - s i - o1 n s
vibrant	n	b i - B r a1 n
vibrar	n	b i - B r a1
vic	n	b i1 k
vicenç	n	b i - s E1 n s
vicent	n	b i - s E1 n
victoriana	n	b i k - t u - r i - a1 - n ax
vidal	n	b i - D a1 l
vident	n	b i - D e1 n
vídeo	n	b i1 - D e - o
videoconferències	n	b i - D ax - u - k u m - f ax - r E1 n - s i - ax s
videogràfic	n	b i - D ax - u - G r a1 - f i k
videojoc	n	b i - D ax - u - Z O1 k
vídeos	n	b i1 - D e - o s
vídua	n	b i1 - D u - ax
vielha	n	b i - E1 - l ax
viena	n	b i - E1 - n ax
vigilància	n	b i - Z i - l a1 n - s i - ax
viladamat	n	b i - l ax - D ax - m a1 t
viladecans	n	b i - l ax - D ax - k a1 n s
viladrau	n	b i - l ax - D r a1 uw
vilafranca	n	b i - l ax - f r a1 N - k ax
vilanova	n	b i - l ax - n O1 - B ax
villalba	n	b i - L a1 l - B ax
vilobí	n	b i - l u - B i1
vilumar	n	b i - l u - m a1
vinagre	n	b i - n a1 - G r ax
vincla	n	b i1 N - k l ax
vinga	n	b i1 N - g ax
vinyeta	n	b i - J E1 - t ax
vinyetes	n	b i - J E1 - t ax s
violoncel	n	b i - u - l u n - s E1 l
virginals	n	b i rr - Z i - n a1 l s
viril	n	b i - r i1 l
virrei	n	b i - rr e1 j
virtuals	n	b i rr - t u - a1 l s
virtuoses	n	b i rr - t u - o1 - z ax s
virulentament	n	b i - r u - l e n - t ax - m e1 n
virus	n	b i1 - r u s
visa	n	b i1 - z ax
visat	n	b i - z a1 t
visibilitat	n	b i - z i - B i - l i - t a1 t
visiblement	n	b i - z i b - b l ax - m e1 n
visionat	n	b i - z i - u - n a1 t
visitants	n	b i - z i - t a1 n s
visquen	n	b i1 s - k ax n
visual	n	b i - z u - a1 l
visualitza	n	b i - z u - ax - l i1 d - z ax
visualitzades	n	b i - z u - ax - l i d - z a1 - D ax s
visualitzador	n	b i - z u - ax - l i d - z ax - D o1
visualitzar	n	b i - z u - ax - l i d - z a1
visualitzeu	n	b i - z u - ax - l i d - z E1 uw
visuals	n	b i - z u - a1 l s
vítria	n	b i1 - t r i - ax
vivers	n	b i - B e1 s
viviane	n	b i - B i - a1 - n ax
vocables	n	b u - k a1 b - b l ax s
vodka	n	b o1 t - k ax
volcàniques	n	b u l - k a1 - n i - k ax s
voletejar	n	b u - l ax - t ax - Z a1
voluntàriament	n	b u - l u n - t a - r i - ax - m e1 n
voluntariat	n	b u - l u n - t ax - r i - a1 t
vorera	n	b u - r e1 - r ax
votació	n	b u - t ax - s i - o1
vudú	n	b u - D u1
vulnerin	n	b u l - n E1 - r i n
walter	n	b ax l - t e1
washington	n	b ax - z i N - t o1 n
webs	n	b e1 p s
web	n	b e1 p
weissmann	n	b ax j - s m a1 n n
wellington	n	b ax - L i N - t o1 n
whiskys	n	b i1 s - k i s
whisky	n	w i1 s - k i
wilson	n	b i l - s o1 n
windows	n	b i n - d o1 p s
wolf	n	b o1 l f
word	n	b o1 rr t
xafogosa	n	S ax - f u - G o1 - z ax
xampinyons	n	S ax m - p i - J o1 n s
xandall	n	S ax n - d a1 L
xandalls	n	S ax n - d a1 L s
xaret	n	S ax - r E1 t
xarranca	n	S ax - rr a1 N - k ax
xarrupa	n	S ax - rr u1 - p ax
xatejar	n	S ax - t ax - Z a1
xauplic	n	S ax uw - p l i1 k
xavala	n	S ax - B a1 - l ax
xavier	n	S ax - B i - e1
xef	n	S E1 f
xeics	n	S E1 j k s
xènia	n	S E1 - n i - ax
xenòfobes	n	S ax - n O1 - f u - B ax s
xèrifs	n	S E1 - r i f s
xerrada	n	S ax - rr a1 - D ax
xerrades	n	S ax - rr a1 - D ax s
xerrant	n	S ax - rr a1 n
xerrar	n	S ax - rr a1
xerrava	n	S ax - rr a1 - B ax
xerraven	n	S ax - rr a1 - B ax n
xerro	n	S E1 - rr u
xerta	n	S E1 rr - t ax
xicago	n	S i - k a1 - G u
xiclets	n	S i - k l E1 t s
xiclet	n	S i - k l E1 t
xicota	n	S i - k O1 - t ax
xifratge	n	S i - f r a1 d - Z ax
xiïta	n	S i - i1 - t ax
xiïtes	n	S i - i1 - t ax s
ximenis	n	S i - m E1 - n i s
ximple	n	S i1 m - p l ax
ximplet	n	S i m - p l E1 t
xinesa	n	S i - n E1 - z ax
xinxes	n	S i1 n - S ax s
xiprers	n	S i - p r e1 s
xip	n	S i1 p
xiqueta	n	S i - k E1 - t ax
xiquets	n	S i - k E1 t s
xiscle	n	S i1 s - k l ax
xi	n	S i1
xiular	n	S i uw - l a1
xiulet	n	S i uw - l E1 t
xiuxiueig	n	S i uw - S i - w E1 tS
xiuxiuejar	n	S i uw - S i - w ax - Z a1
xiuxiueja	n	S i uw - S i - w E1 - Z ax
xiuxiuejava	n	S i uw - S i - w ax - Z a1 - B ax
xocar	n	S u - k a1
xocava	n	S u - k a1 - B ax
xocolatines	n	S u - k u - l ax - t i1 - n ax s
xofer	n	S u - f e1
xop	n	S o1 p
xops	n	S o1 p s
xoquin	n	S O1 - k i n
xoriço	n	S u - r i1 - s u
xou	n	S O1 uw
xumet	n	S u - m E1 t
xupito	n	S u - p i1 - t u
yakarta	n	y ax - k a1 rr - t ax
y	n	i
zagreb	n	z ax - G r e1 p
zara	n	z a1 - r ax
zelanda	n	z ax - l a1 n - d ax
zombi	n	z O1 m - b i
zoòlegs	n	z u - O1 - l ax k s
zoologia	n	z u - u - l u - Z i1 - ax
zoològic	n	z u - u - l O1 - Z i k
zoom	n	z u - o1 m
zoo	n	z o1 - o
zürich	n	z u - r i1 k
